AAAACACAGTGTCACTATC -> AAACACAGTGTCACTATCC
AAAACAGACATCTTTCGAC -> AAACAGACATCTTTCGACC
AAAACGCTCAGTGTGAAGA -> AAACGCTCAGTGTGAAGAG
AAAACTAGTCTCATTGTAC -> AAACTAGTCTCATTGTACC
AAAATAACCTCTGACCCTC -> AAATAACCTCTGACCCTCG
AAACACAGTGTCACTATCC -> AACACAGTGTCACTATCCC
AAACAGACATCTTTCGACC -> AACAGACATCTTTCGACCG
AAACAGCTGCCGTCATTTT -> AACAGCTGCCGTCATTTTT
AAACCGCGAAATAACAATG -> AACCGCGAAATAACAATGC
AAACCTACGCAGGACTTTT -> AACCTACGCAGGACTTTTT
AAACGAGGTCTAACCTTTT -> AACGAGGTCTAACCTTTTT
AAACGCTCAGTGTGAAGAG -> AACGCTCAGTGTGAAGAGT
AAACTAAACTATTACAAGA -> AACTAAACTATTACAAGAG
AAACTACTTTCCACTTTTT -> AACTACTTTCCACTTTTTT
AAACTAGTCTCATTGTACC -> AACTAGTCTCATTGTACCC
AAACTATTACAAGAGCCGG -> AACTATTACAAGAGCCGGA
AAAGAGGCCAGCCGTCTTA -> AAGAGGCCAGCCGTCTTAG
AAAGCTCTCCCGTGTACTT -> AAGCTCTCCCGTGTACTTT
AAATAACAATGCAGGCCCT -> AATAACAATGCAGGCCCTC
AAATAACCTCTGACCCTCG -> AATAACCTCTGACCCTCGT
AAATACGTTATGGCCTAGG -> AATACGTTATGGCCTAGGA
AAATCACAGCTTGGTATTT -> AATCACAGCTTGGTATTTT
AAATCACTCGAGAGGAGAA -> AATCACTCGAGAGGAGAAG
AAATCCTATCGGCCGAAGC -> AATCCTATCGGCCGAAGCC
AAATCGGGACACACGAACT -> AATCGGGACACACGAACTC
AAATTAGGCACGCCATTTA -> AATTAGGCACGCCATTTAA
AAATTCCCAGAAGGGAGTG -> AATTCCCAGAAGGGAGTGA
AACAAGATCTGGTAACATG -> ACAAGATCTGGTAACATGC
AACAATAGTACCGACCTGG -> ACAATAGTACCGACCTGGT
AACAATGCAGGCCCTCAAC -> ACAATGCAGGCCCTCAACG
AACACAGTGTCACTATCCC -> ACACAGTGTCACTATCCCC
AACACCACCGGAGGTATAT -> ACACCACCGGAGGTATATC
AACACGGCATCTATGGTAC -> ACACGGCATCTATGGTACA
AACACGGTCCTAGGAGCCT -> ACACGGTCCTAGGAGCCTT
AACACTTCCGAATCCATTC -> ACACTTCCGAATCCATTCA
AACAGACATCTTTCGACCG -> ACAGACATCTTTCGACCGT
AACAGCTGCCGTCATTTTT -> ACAGCTGCCGTCATTTTTG
AACATGCCCACCATCAAGT -> ACATGCCCACCATCAAGTT
AACATTAAAACGCTCAGTG -> ACATTAAAACGCTCAGTGT
AACATTTCCTTCATCCTCT -> ACATTTCCTTCATCCTCTT
AACCATCGCGACTTTGCCG -> ACCATCGCGACTTTGCCGT
AACCCAGGTGTGACTACTA -> ACCCAGGTGTGACTACTAG
AACCGCGAAATAACAATGC -> ACCGCGAAATAACAATGCA
AACCGGGGCGAGGGTCGGT -> ACCGGGGCGAGGGTCGGTG
AACCTACGCAGGACTTTTT -> ACCTACGCAGGACTTTTTG
AACCTCTGACCCTCGTATC -> ACCTCTGACCCTCGTATCG
AACCTTTTTGACAGCATTT -> ACCTTTTTGACAGCATTTG
AACGAGACACTCTACGTTA -> ACGAGACACTCTACGTTAA
AACGAGGTCTAACCTTTTT -> ACGAGGTCTAACCTTTTTG
AACGCTAGTGTATTTGTCG -> ACGCTAGTGTATTTGTCGC
AACGCTCAGTGTGAAGAGT -> ACGCTCAGTGTGAAGAGTG
AACGGGTTCCTATGATGAT -> ACGGGTTCCTATGATGATG
AACGGTGTACCCTGGAGTG -> ACGGTGTACCCTGGAGTGT
AACGTGGACTAAGTGAGTT -> ACGTGGACTAAGTGAGTTA
AACGTGTCGCGCTTGTCCA -> ACGTGTCGCGCTTGTCCAA
AACGTTAGTGCGAAAATAA -> ACGTTAGTGCGAAAATAAC
AACGTTTATCCAGCTCGAG -> ACGTTTATCCAGCTCGAGC
AACTAAACTATTACAAGAG -> ACTAAACTATTACAAGAGC
AACTACTTTCCACTTTTTT -> ACTACTTTCCACTTTTTTG
AACTAGTCTCATTGTACCC -> ACTAGTCTCATTGTACCCA
AACTATTACAAGAGCCGGA -> ACTATTACAAGAGCCGGAT
AACTCCTTCCGAACGGTGT -> ACTCCTTCCGAACGGTGTA
AACTCTCGCCACTGGTGTC -> ACTCTCGCCACTGGTGTCT
AACTGACCGGTGCAGCCCT -> ACTGACCGGTGCAGCCCTT
AACTGGGTCGACCCGGCTA -> ACTGGGTCGACCCGGCTAG
AACTGTTCTCAAATTAGGC -> ACTGTTCTCAAATTAGGCA
AACTTCCGGACTAAATTCC -> ACTTCCGGACTAAATTCCC
AAGACCACAATTTACCCCG -> AGACCACAATTTACCCCGG
AAGAGCCGGATGGATCCCG -> AGAGCCGGATGGATCCCGC
AAGAGGCCAGCCGTCTTAG -> AGAGGCCAGCCGTCTTAGG
AAGAGTGAACGTTAGTGCG -> AGAGTGAACGTTAGTGCGA
AAGATACGACAATTCGTCT -> AGATACGACAATTCGTCTT
AAGATCTGGTAACATGCCC -> AGATCTGGTAACATGCCCA
AAGCCCTGCTTCACCATCG -> AGCCCTGCTTCACCATCGC
AAGCCGGTTCGTGTCGCGG -> AGCCGGTTCGTGTCGCGGT
AAGCGTTGAGACTTCAAGG -> AGCGTTGAGACTTCAAGGT
AAGCTCTCCCGTGTACTTT -> AGCTCTCCCGTGTACTTTG
AAGCTTGGATGTAATATCG -> AGCTTGGATGTAATATCGA
AAGGGAGTGAGCCCCCGCG -> AGGGAGTGAGCCCCCGCGC
AAGGGGGACCTAAGGTAAT -> AGGGGGACCTAAGGTAATA
AAGGGGTGAGTATATTTAA -> AGGGGTGAGTATATTTAAA
AAGGTAATAGCCTCGGGAC -> AGGTAATAGCCTCGGGACT
AAGGTTCGGTACGGGCGTT -> AGGTTCGGTACGGGCGTTC
AAGTCAACGTGGACTAAGT -> AGTCAACGTGGACTAAGTG
AAGTCATATGATCATCTGA -> AGTCATATGATCATCTGAC
AAGTCGGCTGATCCTCAAC -> AGTCGGCTGATCCTCAACT
AAGTCTTGAGGATGTTGGA -> AGTCTTGAGGATGTTGGAT
AAGTGAGTTATGTTACGCG -> AGTGAGTTATGTTACGCGC
AAGTTCGTAAGTCTTGAGG -> AGTTCGTAAGTCTTGAGGA
AATAACAATGCAGGCCCTC -> ATAACAATGCAGGCCCTCA
AATAACCATCGCGACTTTG -> ATAACCATCGCGACTTTGC
AATAACCTCTGACCCTCGT -> ATAACCTCTGACCCTCGTA
AATAACGAGACACTCTACG -> ATAACGAGACACTCTACGT
AATAAGACCACAATTTACC -> ATAAGACCACAATTTACCC
AATACATAAAACACAGTGT -> ATACATAAAACACAGTGTC
AATACGGGCGTCGACGAAA -> ATACGGGCGTCGACGAAAT
AATACGTTATGGCCTAGGA -> ATACGTTATGGCCTAGGAG
AATAGCCTCGGGACTAGCC -> ATAGCCTCGGGACTAGCCG
AATAGTACCGACCTGGTAA -> ATAGTACCGACCTGGTAAA
AATATATTCTAGTCAGGGT -> ATATATTCTAGTCAGGGTG
AATATCGAGTCGGCCCGAG -> ATATCGAGTCGGCCCGAGC
AATCACAGCTTGGTATTTT -> ATCACAGCTTGGTATTTTG
AATCACTCGAGAGGAGAAG -> ATCACTCGAGAGGAGAAGC
AATCACTTCGAACACGGTC -> ATCACTTCGAACACGGTCC
AATCCATTCACGGTGGATC -> ATCCATTCACGGTGGATCG
AATCCTATCGGCCGAAGCC -> ATCCTATCGGCCGAAGCCC
AATCGGGACACACGAACTC -> ATCGGGACACACGAACTCT
AATGAGGTGTTCCCGTTGT -> ATGAGGTGTTCCCGTTGTA
AATGAGTACAGCGCGTTTA -> ATGAGTACAGCGCGTTTAG
AATGCAGGCCCTCAACGTG -> ATGCAGGCCCTCAACGTGT
AATGGCTGGCTCTCAATGT -> ATGGCTGGCTCTCAATGTC
AATGTCGCGCTTGTCCAAA -> ATGTCGCGCTTGTCCAAAC
AATGTGGTTTTTCCCGGGA -> ATGTGGTTTTTCCCGGGAT
AATTAGGCACGCCATTTAA -> ATTAGGCACGCCATTTAAA
AATTCCCAGAAGGGAGTGA -> ATTCCCAGAAGGGAGTGAG
AATTCGTCTTGATCTGCGT -> ATTCGTCTTGATCTGCGTC
AATTCTCGAGATAATACAT -> ATTCTCGAGATAATACATA
AATTTACCCCGGTGTCTTC -> ATTTACCCCGGTGTCTTCG
ACAAAACAGACATCTTTCG -> CAAAACAGACATCTTTCGA
ACAAATCACTCGAGAGGAG -> CAAATCACTCGAGAGGAGA
ACAACTTCCGGACTAAATT -> CAACTTCCGGACTAAATTC
ACAAGAGCCGGATGGATCC -> CAAGAGCCGGATGGATCCC
ACAAGATCTGGTAACATGC -> CAAGATCTGGTAACATGCC
ACAATAGTACCGACCTGGT -> CAATAGTACCGACCTGGTA
ACAATGCAGGCCCTCAACG -> CAATGCAGGCCCTCAACGT
ACAATTCGTCTTGATCTGC -> CAATTCGTCTTGATCTGCG
ACAATTTACCCCGGTGTCT -> CAATTTACCCCGGTGTCTT
ACACACGAACTCTCGCCAC -> CACACGAACTCTCGCCACT
ACACAGTGTCACTATCCCC -> CACAGTGTCACTATCCCCG
ACACCACCGGAGGTATATC -> CACCACCGGAGGTATATCA
ACACCCCGGTAACACCACC -> CACCCCGGTAACACCACCG
ACACCGGCGATGGGTGAGC -> CACCGGCGATGGGTGAGCT
ACACGAACTCTCGCCACTG -> CACGAACTCTCGCCACTGG
ACACGGCATCTATGGTACA -> CACGGCATCTATGGTACAG
ACACGGTCCTAGGAGCCTT -> CACGGTCCTAGGAGCCTTT
ACACTCTACGTTAATATAT -> CACTCTACGTTAATATATT
ACACTTCCGAATCCATTCA -> CACTTCCGAATCCATTCAC
ACAGACATCTTTCGACCGT -> CAGACATCTTTCGACCGTA
ACAGCAGTGTCATAGTTAT -> CAGCAGTGTCATAGTTATT
ACAGCAGTTCTACTAATTC -> CAGCAGTTCTACTAATTCT
ACAGCATTTGTTGCAGATT -> CAGCATTTGTTGCAGATTG
ACAGCATTTGTTGCCAGGG -> CAGCATTTGTTGCCAGGGC
ACAGCATTTGTTGGCGGCG -> CAGCATTTGTTGGCGGCGT
ACAGCATTTGTTGGCTAGG -> CAGCATTTGTTGGCTAGGG
ACAGCGCGTTTAGGGCCAA -> CAGCGCGTTTAGGGCCAAA
ACAGCGCTCGATCCGAGCC -> CAGCGCTCGATCCGAGCCC
ACAGCTGCCGTCATTTTTG -> CAGCTGCCGTCATTTTTGA
ACAGCTTGGTATTTTGAAC -> CAGCTTGGTATTTTGAACT
ACAGGTCCAAGATACGACA -> CAGGTCCAAGATACGACAA
ACAGTGTCACTATCCCCGG -> CAGTGTCACTATCCCCGGA
ACAGTTCTTATCGTCGAAG -> CAGTTCTTATCGTCGAAGG
ACATAAAACACAGTGTCAC -> CATAAAACACAGTGTCACT
ACATAGACTGTTATGAACA -> CATAGACTGTTATGAACAC
ACATCTTTCGACCGTACCT -> CATCTTTCGACCGTACCTC
ACATGCCCACCATCAAGTT -> CATGCCCACCATCAAGTTC
ACATGGTAGCCCCACAAAA -> CATGGTAGCCCCACAAAAC
ACATTAAAACGCTCAGTGT -> CATTAAAACGCTCAGTGTG
ACATTTCCTTCATCCTCTT -> CATTTCCTTCATCCTCTTG
ACCACAATTTACCCCGGTG -> CCACAATTTACCCCGGTGT
ACCACCGGAGGTATATCAA -> CCACCGGAGGTATATCAAA
ACCAGCGTAGGTGTGATGG -> CCAGCGTAGGTGTGATGGA
ACCATCAAGTTCGTAAGTC -> CCATCAAGTTCGTAAGTCT
ACCATCGCCACGGTCGAGA -> CCATCGCCACGGTCGAGAG
ACCATCGCGACTTTGCCGT -> CCATCGCGACTTTGCCGTC
ACCCAGGTGTGACTACTAG -> CCCAGGTGTGACTACTAGA
ACCCATTAGTGCCAGAGAC -> CCCATTAGTGCCAGAGACG
ACCCCGGTAACACCACCGG -> CCCCGGTAACACCACCGGA
ACCCCGGTGTCTTCGCAGT -> CCCCGGTGTCTTCGCAGTG
ACCCCTGTGGATCATCTGG -> CCCCTGTGGATCATCTGGG
ACCCGCTCCTTTCAGCGGG -> CCCGCTCCTTTCAGCGGGC
ACCCGGCTAGAAGTGTGCT -> CCCGGCTAGAAGTGTGCTG
ACCCTCGTATCGACTTAAC -> CCCTCGTATCGACTTAACA
ACCCTGGAGTGTACACCCC -> CCCTGGAGTGTACACCCCG
ACCGACCTGGTAAAGAGGC -> CCGACCTGGTAAAGAGGCC
ACCGCGAAATAACAATGCA -> CCGCGAAATAACAATGCAG
ACCGGAGGTATATCAAAGC -> CCGGAGGTATATCAAAGCT
ACCGGCGATGGGTGAGCTC -> CCGGCGATGGGTGAGCTCA
ACCGGGGCGAGGGTCGGTG -> CCGGGGCGAGGGTCGGTGT
ACCGGTGCAGCCCTTACAC -> CCGGTGCAGCCCTTACACC
ACCGTACCTCTAATGGCTG -> CCGTACCTCTAATGGCTGG
ACCTAAGGTAATAGCCTCG -> CCTAAGGTAATAGCCTCGG
ACCTACGCAGGACTTTTTG -> CCTACGCAGGACTTTTTGA
ACCTCTAATGGCTGGCTCT -> CCTCTAATGGCTGGCTCTC
ACCTCTGACCCTCGTATCG -> CCTCTGACCCTCGTATCGA
ACCTGGTAAAGAGGCCAGC -> CCTGGTAAAGAGGCCAGCC
ACCTTTTTGACAGCATTTG -> CCTTTTTGACAGCATTTGT
ACGAAATCGGGACACACGA -> CGAAATCGGGACACACGAA
ACGAACTCTCGCCACTGGT -> CGAACTCTCGCCACTGGTG
ACGACAATTCGTCTTGATC -> CGACAATTCGTCTTGATCT
ACGAGACACTCTACGTTAA -> CGAGACACTCTACGTTAAT
ACGAGGTCTAACCTTTTTG -> CGAGGTCTAACCTTTTTGA
ACGAGTAATCACTTCGAAC -> CGAGTAATCACTTCGAACA
ACGCAGGACTTTTTGACAG -> CGCAGGACTTTTTGACAGC
ACGCCATTTAAATACGTTA -> CGCCATTTAAATACGTTAT
ACGCCGATTGCGGTGGAAT -> CGCCGATTGCGGTGGAATG
ACGCGCCTTTATCCAGACT -> CGCGCCTTTATCCAGACTC
ACGCTAGTGTATTTGTCGC -> CGCTAGTGTATTTGTCGCG
ACGCTCAGTGTGAAGAGTG -> CGCTCAGTGTGAAGAGTGA
ACGGCATCTATGGTACAGG -> CGGCATCTATGGTACAGGT
ACGGGCGTCGACGAAATCG -> CGGGCGTCGACGAAATCGG
ACGGGCGTTCGGGCAACAA -> CGGGCGTTCGGGCAACAAG
ACGGGTTCCTATGATGATG -> CGGGTTCCTATGATGATGG
ACGGTCCTAGGAGCCTTTG -> CGGTCCTAGGAGCCTTTGT
ACGGTCGAGAGCGTTTATC -> CGGTCGAGAGCGTTTATCC
ACGGTGGATCGTTGCGCAC -> CGGTGGATCGTTGCGCACA
ACGGTGTAAATCACAGCTT -> CGGTGTAAATCACAGCTTG
ACGGTGTACCCTGGAGTGT -> CGGTGTACCCTGGAGTGTA
ACGTCGGGACGCCGATTGC -> CGTCGGGACGCCGATTGCG
ACGTGGACTAAGTGAGTTA -> CGTGGACTAAGTGAGTTAT
ACGTGGAGAACGGGTTCCT -> CGTGGAGAACGGGTTCCTA
ACGTGGTAGAATAACCATC -> CGTGGTAGAATAACCATCG
ACGTGTCGCGCTTGTCCAA -> CGTGTCGCGCTTGTCCAAA
ACGTTAAGCGTTGAGACTT -> CGTTAAGCGTTGAGACTTC
ACGTTAATATATTCTAGTC -> CGTTAATATATTCTAGTCA
ACGTTAGTGCGAAAATAAC -> CGTTAGTGCGAAAATAACC
ACGTTATGGCCTAGGAGAA -> CGTTATGGCCTAGGAGAAC
ACGTTTACGTTAAGCGTTG -> CGTTTACGTTAAGCGTTGA
ACGTTTATCCAGCTCGAGC -> CGTTTATCCAGCTCGAGCC
ACTAAACTATTACAAGAGC -> CTAAACTATTACAAGAGCC
ACTAAATTCCCAGAAGGGA -> CTAAATTCCCAGAAGGGAG
ACTAAGTGAGTTATGTTAC -> CTAAGTGAGTTATGTTACG
ACTAATTCTCGAGATAATA -> CTAATTCTCGAGATAATAC
ACTACTAGATTGCGCTCAC -> CTACTAGATTGCGCTCACA
ACTACTTTCCACTTTTTTG -> CTACTTTCCACTTTTTTGA
ACTAGAAGTCAACGTGGAC -> CTAGAAGTCAACGTGGACT
ACTAGATTGCGCTCACATG -> CTAGATTGCGCTCACATGG
ACTAGCCGGTATCTAAGTC -> CTAGCCGGTATCTAAGTCG
ACTAGTCTCATTGTACCCA -> CTAGTCTCATTGTACCCAT
ACTATCCCCGGAGGCCTAT -> CTATCCCCGGAGGCCTATA
ACTATTACAAGAGCCGGAT -> CTATTACAAGAGCCGGATG
ACTCAGACCAGCGTAGGTG -> CTCAGACCAGCGTAGGTGT
ACTCCGAACATTAAAACGC -> CTCCGAACATTAAAACGCT
ACTCCTTCCGAACGGTGTA -> CTCCTTCCGAACGGTGTAC
ACTCGAGAGGAGAAGCTTG -> CTCGAGAGGAGAAGCTTGG
ACTCGCTCAGTCCTAGAGG -> CTCGCTCAGTCCTAGAGGA
ACTCTACGTTAATATATTC -> CTCTACGTTAATATATTCT
ACTCTCGCCACTGGTGTCT -> CTCTCGCCACTGGTGTCTA
ACTCTGAGACCCCTGTGGA -> CTCTGAGACCCCTGTGGAT
ACTGACCGGTGCAGCCCTT -> CTGACCGGTGCAGCCCTTA
ACTGACTCGCTCAGTCCTA -> CTGACTCGCTCAGTCCTAG
ACTGACTGACTCGCTCAGT -> CTGACTGACTCGCTCAGTC
ACTGGGTCGACCCGGCTAG -> CTGGGTCGACCCGGCTAGA
ACTGGTGTCTACTTTATGA -> CTGGTGTCTACTTTATGAG
ACTGTCGCGCTTGTCCAAA -> CTGTCGCGCTTGTCCAAAC
ACTGTTATGAACACTTCCG -> CTGTTATGAACACTTCCGA
ACTGTTCTCAAATTAGGCA -> CTGTTCTCAAATTAGGCAC
ACTTAACATTTCCTTCATC -> CTTAACATTTCCTTCATCC
ACTTCAAGGTTCGGTACGG -> CTTCAAGGTTCGGTACGGG
ACTTCCGAATCCATTCACG -> CTTCCGAATCCATTCACGG
ACTTCCGGACTAAATTCCC -> CTTCCGGACTAAATTCCCA
ACTTCGAACACGGTCCTAG -> CTTCGAACACGGTCCTAGG
ACTTTATGAGTGATGAGTG -> CTTTATGAGTGATGAGTGA
ACTTTCCACTTTTTTGACA -> CTTTCCACTTTTTTGACAG
ACTTTGATTGCAGTTTAAA -> CTTTGATTGCAGTTTAAAA
ACTTTGCCGTCCGTCGGCT -> CTTTGCCGTCCGTCGGCTG
ACTTTTTGACAGCATTTGT -> CTTTTTGACAGCATTTGTT
ACTTTTTTGACAGCATTTG -> CTTTTTTGACAGCATTTGT
AGAAACCGCGAAATAACAA -> GAAACCGCGAAATAACAAT
AGAACGCTAGTGTATTTGT -> GAACGCTAGTGTATTTGTC
AGAACGGGTTCCTATGATG -> GAACGGGTTCCTATGATGA
AGAAGCTTGGATGTAATAT -> GAAGCTTGGATGTAATATC
AGAAGGGAGTGAGCCCCCG -> GAAGGGAGTGAGCCCCCGC
AGAAGTCAACGTGGACTAA -> GAAGTCAACGTGGACTAAG
AGAATAACCATCGCGACTT -> GAATAACCATCGCGACTTT
AGACACTCTACGTTAATAT -> GACACTCTACGTTAATATA
AGACATCTTTCGACCGTAC -> GACATCTTTCGACCGTACC
AGACCACAATTTACCCCGG -> GACCACAATTTACCCCGGT
AGACCAGCGTAGGTGTGAT -> GACCAGCGTAGGTGTGATG
AGACCCCTGTGGATCATCT -> GACCCCTGTGGATCATCTG
AGACGAGTAATCACTTCGA -> GACGAGTAATCACTTCGAA
AGACTCTGAGACCCCTGTG -> GACTCTGAGACCCCTGTGG
AGACTGTTATGAACACTTC -> GACTGTTATGAACACTTCC
AGACTTCAAGGTTCGGTAC -> GACTTCAAGGTTCGGTACG
AGAGACGAGTAATCACTTC -> GAGACGAGTAATCACTTCG
AGAGCCGAGTGTCTCTGTA -> GAGCCGAGTGTCTCTGTAA
AGAGCCGGATGGATCCCGC -> GAGCCGGATGGATCCCGCA
AGAGCGTTTATCCATGGGG -> GAGCGTTTATCCATGGGGG
AGAGGAACAATAGTACCGA -> GAGGAACAATAGTACCGAC
AGAGGAGAAGCTTGGATGT -> GAGGAGAAGCTTGGATGTA
AGAGGCCAGCCGTCTTAGG -> GAGGCCAGCCGTCTTAGGG
AGAGTGAACGTTAGTGCGA -> GAGTGAACGTTAGTGCGAA
AGATAATACATAAAACACA -> GATAATACATAAAACACAG
AGATACGACAATTCGTCTT -> GATACGACAATTCGTCTTG
AGATCTCACAGTTCTTATC -> GATCTCACAGTTCTTATCG
AGATCTGGTAACATGCCCA -> GATCTGGTAACATGCCCAC
AGATTGCGCTCACATGGTA -> GATTGCGCTCACATGGTAG
AGATTGGCTGTATAGGCCA -> GATTGGCTGTATAGGCCAG
AGCAACTCCTTCCGAACGG -> GCAACTCCTTCCGAACGGT
AGCACTCAGACCAGCGTAG -> GCACTCAGACCAGCGTAGG
AGCAGTGTCATAGTTATTT -> GCAGTGTCATAGTTATTTG
AGCAGTTCTACTAATTCTC -> GCAGTTCTACTAATTCTCG
AGCATTTGTTGCAGATTGG -> GCATTTGTTGCAGATTGGC
AGCATTTGTTGCCAGGGCT -> GCATTTGTTGCCAGGGCTG
AGCATTTGTTGGCGGCGTC -> GCATTTGTTGGCGGCGTCA
AGCATTTGTTGGCTAGGGT -> GCATTTGTTGGCTAGGGTG
AGCCCCAAGGGGGACCTAA -> GCCCCAAGGGGGACCTAAG
AGCCCCACAAAACAGACAT -> GCCCCACAAAACAGACATC
AGCCCCCGCGCAGCACTCA -> GCCCCCGCGCAGCACTCAG
AGCCCTACTGTCGCGCTTG -> GCCCTACTGTCGCGCTTGT
AGCCCTGCTTCACCATCGC -> GCCCTGCTTCACCATCGCC
AGCCCTTACACCGGCGATG -> GCCCTTACACCGGCGATGG
AGCCGAGTGTCTCTGTAAG -> GCCGAGTGTCTCTGTAAGC
AGCCGGATGGATCCCGCAG -> GCCGGATGGATCCCGCAGT
AGCCGGTATCTAAGTCGGC -> GCCGGTATCTAAGTCGGCT
AGCCGGTTCGTGTCGCGGT -> GCCGGTTCGTGTCGCGGTA
AGCCGTCTTAGGGCGACAG -> GCCGTCTTAGGGCGACAGC
AGCCTCGGGACTAGCCGGT -> GCCTCGGGACTAGCCGGTA
AGCCTTTGTCGTTATTAGG -> GCCTTTGTCGTTATTAGGG
AGCGCGTTTAGGGCCAAAC -> GCGCGTTTAGGGCCAAACT
AGCGCTCGATCCGAGCCCT -> GCGCTCGATCCGAGCCCTA
AGCGGGCACGTGGAGAACG -> GCGGGCACGTGGAGAACGG
AGCGGTGCCAGGCTCCCGT -> GCGGTGCCAGGCTCCCGTG
AGCGTAGGTGTGATGGATG -> GCGTAGGTGTGATGGATGA
AGCGTTGAGACTTCAAGGT -> GCGTTGAGACTTCAAGGTT
AGCGTTTATCCATGGGGGA -> GCGTTTATCCATGGGGGAC
AGCTCACAAATCACTCGAG -> GCTCACAAATCACTCGAGA
AGCTCGAGCCCCAAGGGGG -> GCTCGAGCCCCAAGGGGGA
AGCTCTCCCGTGTACTTTG -> GCTCTCCCGTGTACTTTGA
AGCTGAGGTTATACAGCAG -> GCTGAGGTTATACAGCAGT
AGCTGCCGTCATTTTTGAC -> GCTGCCGTCATTTTTGACA
AGCTTCGGTCTTGTTCGCG -> GCTTCGGTCTTGTTCGCGT
AGCTTGGATGTAATATCGA -> GCTTGGATGTAATATCGAG
AGCTTGGTATTTTGAACTG -> GCTTGGTATTTTGAACTGG
AGGAACAATAGTACCGACC -> GGAACAATAGTACCGACCT
AGGACTTTTTGACAGCATT -> GGACTTTTTGACAGCATTT
AGGAGAACGCTAGTGTATT -> GGAGAACGCTAGTGTATTT
AGGAGAAGCTTGGATGTAA -> GGAGAAGCTTGGATGTAAT
AGGAGCCTTTGTCGTTATT -> GGAGCCTTTGTCGTTATTA
AGGATAACGTTTATCCAGC -> GGATAACGTTTATCCAGCT
AGGATGTTGGATAGGATAA -> GGATGTTGGATAGGATAAC
AGGCACGCCATTTAAATAC -> GGCACGCCATTTAAATACG
AGGCCAGCCGTCTTAGGGC -> GGCCAGCCGTCTTAGGGCG
AGGCCAGCTGAGGTTATAC -> GGCCAGCTGAGGTTATACA
AGGCCCTCAACGTGTCGCG -> GGCCCTCAACGTGTCGCGC
AGGCCTATAAGTCATATGA -> GGCCTATAAGTCATATGAT
AGGCTCCCGTGGCAATAAC -> GGCTCCCGTGGCAATAACG
AGGGAGTGAGCCCCCGCGC -> GGGAGTGAGCCCCCGCGCA
AGGGCAGTCAATGTGGTTT -> GGGCAGTCAATGTGGTTTT
AGGGCCAAACTAAACTATT -> GGGCCAAACTAAACTATTA
AGGGCGACAGCAGTGTCAT -> GGGCGACAGCAGTGTCATA
AGGGCTGTTACGTTTACGT -> GGGCTGTTACGTTTACGTT
AGGGGGACCTAAGGTAATA -> GGGGGACCTAAGGTAATAG
AGGGGGTTGATTTGGGAGA -> GGGGGTTGATTTGGGAGAG
AGGGGTGAGTATATTTAAA -> GGGGTGAGTATATTTAAAT
AGGGTCGGTGTGTTAGATC -> GGGTCGGTGTGTTAGATCT
AGGGTGATATTTTTAACTG -> GGGTGATATTTTTAACTGA
AGGGTGCGGAGAAACCGCG -> GGGTGCGGAGAAACCGCGA
AGGTAATAGCCTCGGGACT -> GGTAATAGCCTCGGGACTA
AGGTACGGTGTAAATCACA -> GGTACGGTGTAAATCACAG
AGGTATATCAAAGCTCTCC -> GGTATATCAAAGCTCTCCC
AGGTCCAAGATACGACAAT -> GGTCCAAGATACGACAATT
AGGTCTAACCTTTTTGACA -> GGTCTAACCTTTTTGACAG
AGGTGTGACTACTAGATTG -> GGTGTGACTACTAGATTGC
AGGTGTGATGGATGATAAC -> GGTGTGATGGATGATAACC
AGGTGTTCCCGTTGTATAT -> GGTGTTCCCGTTGTATATG
AGGTTATACAGCAGTTCTA -> GGTTATACAGCAGTTCTAC
AGGTTCGGTACGGGCGTTC -> GGTTCGGTACGGGCGTTCG
AGTAATCACTTCGAACACG -> GTAATCACTTCGAACACGG
AGTACAGCGCGTTTAGGGC -> GTACAGCGCGTTTAGGGCC
AGTACCGACCTGGTAAAGA -> GTACCGACCTGGTAAAGAG
AGTATATTTAAATCCTATC -> GTATATTTAAATCCTATCG
AGTCAACGTGGACTAAGTG -> GTCAACGTGGACTAAGTGA
AGTCAATGTGGTTTTTCCC -> GTCAATGTGGTTTTTCCCG
AGTCAGGGTGATATTTTTA -> GTCAGGGTGATATTTTTAA
AGTCATATGATCATCTGAC -> GTCATATGATCATCTGACA
AGTCCTAGAGGAACAATAG -> GTCCTAGAGGAACAATAGT
AGTCGGCCCGAGCAACTCC -> GTCGGCCCGAGCAACTCCT
AGTCGGCTGATCCTCAACT -> GTCGGCTGATCCTCAACTG
AGTCTCATTGTACCCATTA -> GTCTCATTGTACCCATTAG
AGTCTTGAGGATGTTGGAT -> GTCTTGAGGATGTTGGATA
AGTGAACACGGCATCTATG -> GTGAACACGGCATCTATGG
AGTGAACGTTAGTGCGAAA -> GTGAACGTTAGTGCGAAAA
AGTGACTAGAAGTCAACGT -> GTGACTAGAAGTCAACGTG
AGTGAGCCCCCGCGCAGCA -> GTGAGCCCCCGCGCAGCAC
AGTGAGTTATGTTACGCGC -> GTGAGTTATGTTACGCGCC
AGTGATGAGTGACTAGAAG -> GTGATGAGTGACTAGAAGT
AGTGCCAGAGACGAGTAAT -> GTGCCAGAGACGAGTAATC
AGTGCGAAAATAACCTCTG -> GTGCGAAAATAACCTCTGA
AGTGTACACCCCGGTAACA -> GTGTACACCCCGGTAACAC
AGTGTATTTGTCGCGCTTG -> GTGTATTTGTCGCGCTTGT
AGTGTCACTATCCCCGGAG -> GTGTCACTATCCCCGGAGG
AGTGTCATAGTTATTTGTC -> GTGTCATAGTTATTTGTCC
AGTGTCTCTGTAAGCCGGT -> GTGTCTCTGTAAGCCGGTT
AGTGTGAAGAGTGAACGTT -> GTGTGAAGAGTGAACGTTA
AGTTATGTTACGCGCCTTT -> GTTATGTTACGCGCCTTTA
AGTTATTTGTCCGTACCCG -> GTTATTTGTCCGTACCCGC
AGTTCAATACGGGCGTCGA -> GTTCAATACGGGCGTCGAC
AGTTCGTAAGTCTTGAGGA -> GTTCGTAAGTCTTGAGGAT
AGTTCTACTAATTCTCGAG -> GTTCTACTAATTCTCGAGA
AGTTCTTATCGTCGAAGGG -> GTTCTTATCGTCGAAGGGG
AGTTTAAAACTAGTCTCAT -> GTTTAAAACTAGTCTCATT
ATAAAACACAGTGTCACTA -> TAAAACACAGTGTCACTAT
ATAACAATGCAGGCCCTCA -> TAACAATGCAGGCCCTCAA
ATAACCATCGCGACTTTGC -> TAACCATCGCGACTTTGCC
ATAACCCAGGTGTGACTAC -> TAACCCAGGTGTGACTACT
ATAACCGGGGCGAGGGTCG -> TAACCGGGGCGAGGGTCGG
ATAACCTCTGACCCTCGTA -> TAACCTCTGACCCTCGTAT
ATAACGAGACACTCTACGT -> TAACGAGACACTCTACGTT
ATAACGTTTATCCAGCTCG -> TAACGTTTATCCAGCTCGA
ATAAGACCACAATTTACCC -> TAAGACCACAATTTACCCC
ATAAGTCATATGATCATCT -> TAAGTCATATGATCATCTG
ATAATAAGACCACAATTTA -> TAATAAGACCACAATTTAC
ATAATACATAAAACACAGT -> TAATACATAAAACACAGTG
ATACAGCAGTTCTACTAAT -> TACAGCAGTTCTACTAATT
ATACATAAAACACAGTGTC -> TACATAAAACACAGTGTCA
ATACGACAATTCGTCTTGA -> TACGACAATTCGTCTTGAT
ATACGGGCGTCGACGAAAT -> TACGGGCGTCGACGAAATC
ATACGTTATGGCCTAGGAG -> TACGTTATGGCCTAGGAGA
ATAGACTGTTATGAACACT -> TAGACTGTTATGAACACTT
ATAGCCTCGGGACTAGCCG -> TAGCCTCGGGACTAGCCGG
ATAGGATAACGTTTATCCA -> TAGGATAACGTTTATCCAG
ATAGGCCAGCTGAGGTTAT -> TAGGCCAGCTGAGGTTATA
ATAGTACCGACCTGGTAAA -> TAGTACCGACCTGGTAAAG
ATAGTTATTTGTCCGTACC -> TAGTTATTTGTCCGTACCC
ATATAATAAGACCACAATT -> TATAATAAGACCACAATTT
ATATATTCTAGTCAGGGTG -> TATATTCTAGTCAGGGTGA
ATATCAAAGCTCTCCCGTG -> TATCAAAGCTCTCCCGTGT
ATATCGAGTCGGCCCGAGC -> TATCGAGTCGGCCCGAGCA
ATATGATCATCTGACAGCG -> TATGATCATCTGACAGCGC
ATATGGATGCATTTCTATG -> TATGGATGCATTTCTATGT
ATATGTTAGGGCAGTCAAT -> TATGTTAGGGCAGTCAATG
ATATTCTAGTCAGGGTGAT -> TATTCTAGTCAGGGTGATA
ATATTTAAATCCTATCGGC -> TATTTAAATCCTATCGGCC
ATATTTTTAACTGACCGGT -> TATTTTTAACTGACCGGTG
ATCAAAGCTCTCCCGTGTA -> TCAAAGCTCTCCCGTGTAC
ATCAAGTTCGTAAGTCTTG -> TCAAGTTCGTAAGTCTTGA
ATCACAGCTTGGTATTTTG -> TCACAGCTTGGTATTTTGA
ATCACTCGAGAGGAGAAGC -> TCACTCGAGAGGAGAAGCT
ATCACTTCGAACACGGTCC -> TCACTTCGAACACGGTCCT
ATCATCTGACAGCGCTCGA -> TCATCTGACAGCGCTCGAT
ATCATCTGGGGTGATAACC -> TCATCTGGGGTGATAACCG
ATCCAGACTCTGAGACCCC -> TCCAGACTCTGAGACCCCT
ATCCAGCTCGAGCCCCAAG -> TCCAGCTCGAGCCCCAAGG
ATCCATGGGGGACATAGAC -> TCCATGGGGGACATAGACT
ATCCATTCACGGTGGATCG -> TCCATTCACGGTGGATCGT
ATCCCCGGAGGCCTATAAG -> TCCCCGGAGGCCTATAAGT
ATCCCGCAGTTCAATACGG -> TCCCGCAGTTCAATACGGG
ATCCGAGCCCTACTGTCGC -> TCCGAGCCCTACTGTCGCG
ATCCTATCGGCCGAAGCCC -> TCCTATCGGCCGAAGCCCT
ATCCTCAACTGTTCTCAAA -> TCCTCAACTGTTCTCAAAT
ATCCTCTTGATATGTTAGG -> TCCTCTTGATATGTTAGGG
ATCGACTTAACATTTCCTT -> TCGACTTAACATTTCCTTC
ATCGAGTCGGCCCGAGCAA -> TCGAGTCGGCCCGAGCAAC
ATCGCCACGGTCGAGAGCG -> TCGCCACGGTCGAGAGCGT
ATCGCGACTTTGCCGTCCG -> TCGCGACTTTGCCGTCCGT
ATCGGCCGAAGCCCTGCTT -> TCGGCCGAAGCCCTGCTTC
ATCGGGACACACGAACTCT -> TCGGGACACACGAACTCTC
ATCGTCGAAGGGGTGAGTA -> TCGTCGAAGGGGTGAGTAT
ATCGTTGCGCACAACTTCC -> TCGTTGCGCACAACTTCCG
ATCTAAGTCGGCTGATCCT -> TCTAAGTCGGCTGATCCTC
ATCTATGGTACAGGTCCAA -> TCTATGGTACAGGTCCAAG
ATCTCACAGTTCTTATCGT -> TCTCACAGTTCTTATCGTC
ATCTGACAGCGCTCGATCC -> TCTGACAGCGCTCGATCCG
ATCTGCGTAGCTTCGGTCT -> TCTGCGTAGCTTCGGTCTT
ATCTGCGTCCTACTGACTG -> TCTGCGTCCTACTGACTGA
ATCTGGGGTGATAACCGGG -> TCTGGGGTGATAACCGGGG
ATCTGGTAACATGCCCACC -> TCTGGTAACATGCCCACCA
ATCTTTCGACCGTACCTCT -> TCTTTCGACCGTACCTCTA
ATGAACACTTCCGAATCCA -> TGAACACTTCCGAATCCAT
ATGAGGTGTTCCCGTTGTA -> TGAGGTGTTCCCGTTGTAT
ATGAGTACAGCGCGTTTAG -> TGAGTACAGCGCGTTTAGG
ATGAGTGACTAGAAGTCAA -> TGAGTGACTAGAAGTCAAC
ATGAGTGATGAGTGACTAG -> TGAGTGATGAGTGACTAGA
ATGATAACCCAGGTGTGAC -> TGATAACCCAGGTGTGACT
ATGATCATCTGACAGCGCT -> TGATCATCTGACAGCGCTC
ATGATGATGGGTCATCTGC -> TGATGATGGGTCATCTGCG
ATGATGGGTCATCTGCGTA -> TGATGGGTCATCTGCGTAG
ATGCAGGCCCTCAACGTGT -> TGCAGGCCCTCAACGTGTC
ATGCATTTCTATGTGTTTA -> TGCATTTCTATGTGTTTAG
ATGCCCACCATCAAGTTCG -> TGCCCACCATCAAGTTCGT
ATGCCTTCTGCTGGCTTAC -> TGCCTTCTGCTGGCTTACG
ATGGATCCCGCAGTTCAAT -> TGGATCCCGCAGTTCAATA
ATGGATGATAACCCAGGTG -> TGGATGATAACCCAGGTGT
ATGGATGCATTTCTATGTG -> TGGATGCATTTCTATGTGT
ATGGCCTAGGAGAACGCTA -> TGGCCTAGGAGAACGCTAG
ATGGCTGGCTCTCAATGTC -> TGGCTGGCTCTCAATGTCG
ATGGGGGACATAGACTGTT -> TGGGGGACATAGACTGTTA
ATGGGTCATCTGCGTAGCT -> TGGGTCATCTGCGTAGCTT
ATGGGTGAGCTCACAAATC -> TGGGTGAGCTCACAAATCA
ATGGTACAGGTCCAAGATA -> TGGTACAGGTCCAAGATAC
ATGGTAGCCCCACAAAACA -> TGGTAGCCCCACAAAACAG
ATGTAATATCGAGTCGGCC -> TGTAATATCGAGTCGGCCC
ATGTCGCGCTTGTCCAAAC -> TGTCGCGCTTGTCCAAACA
ATGTGGTTTTTCCCGGGAT -> TGTGGTTTTTCCCGGGATG
ATGTGTTTAGCGGTGCCAG -> TGTGTTTAGCGGTGCCAGG
ATGTTACGCGCCTTTATCC -> TGTTACGCGCCTTTATCCA
ATGTTAGGGCAGTCAATGT -> TGTTAGGGCAGTCAATGTG
ATGTTGGATAGGATAACGT -> TGTTGGATAGGATAACGTT
ATTAAAACGCTCAGTGTGA -> TTAAAACGCTCAGTGTGAA
ATTACAAGAGCCGGATGGA -> TTACAAGAGCCGGATGGAT
ATTAGGCACGCCATTTAAA -> TTAGGCACGCCATTTAAAT
ATTAGGGGGTTGATTTGGG -> TTAGGGGGTTGATTTGGGA
ATTAGTGCCAGAGACGAGT -> TTAGTGCCAGAGACGAGTA
ATTCACGGTGGATCGTTGC -> TTCACGGTGGATCGTTGCG
ATTCCCAGAAGGGAGTGAG -> TTCCCAGAAGGGAGTGAGC
ATTCGTCTTGATCTGCGTC -> TTCGTCTTGATCTGCGTCC
ATTCTAGTCAGGGTGATAT -> TTCTAGTCAGGGTGATATT
ATTCTCGAGATAATACATA -> TTCTCGAGATAATACATAA
ATTGCAGTTTAAAACTAGT -> TTGCAGTTTAAAACTAGTC
ATTGCGCTCACATGGTAGC -> TTGCGCTCACATGGTAGCC
ATTGCGGTGGAATGAGGTG -> TTGCGGTGGAATGAGGTGT
ATTGGCTGTATAGGCCAGC -> TTGGCTGTATAGGCCAGCT
ATTGTACCCATTAGTGCCA -> TTGTACCCATTAGTGCCAG
ATTTAAATACGTTATGGCC -> TTTAAATACGTTATGGCCT
ATTTAAATCCTATCGGCCG -> TTTAAATCCTATCGGCCGA
ATTTACCCCGGTGTCTTCG -> TTTACCCCGGTGTCTTCGC
ATTTCCTTCATCCTCTTGA -> TTTCCTTCATCCTCTTGAT
ATTTCTATGTGTTTAGCGG -> TTTCTATGTGTTTAGCGGT
ATTTGGGAGAGCCGAGTGT -> TTTGGGAGAGCCGAGTGTC
ATTTGTCCGTACCCGCTCC -> TTTGTCCGTACCCGCTCCT
ATTTGTCGCGCTTGTCCAA -> TTTGTCGCGCTTGTCCAAA
ATTTGTTGCAGATTGGCTG -> TTTGTTGCAGATTGGCTGT
ATTTGTTGCCAGGGCTGTT -> TTTGTTGCCAGGGCTGTTA
ATTTGTTGGCGGCGTCATA -> TTTGTTGGCGGCGTCATAT
ATTTGTTGGCTAGGGTGCG -> TTTGTTGGCTAGGGTGCGG
ATTTTGAACTGGGTCGACC -> TTTTGAACTGGGTCGACCC
ATTTTTAACTGACCGGTGC -> TTTTTAACTGACCGGTGCA
ATTTTTGACAGCATTTGTT -> TTTTTGACAGCATTTGTTG
CAAAACAGACATCTTTCGA -> AAAACAGACATCTTTCGAC
CAAACAGCTGCCGTCATTT -> AAACAGCTGCCGTCATTTT
CAAACCTACGCAGGACTTT -> AAACCTACGCAGGACTTTT
CAAACGAGGTCTAACCTTT -> AAACGAGGTCTAACCTTTT
CAAACTAAACTATTACAAG -> AAACTAAACTATTACAAGA
CAAACTACTTTCCACTTTT -> AAACTACTTTCCACTTTTT
CAAAGCTCTCCCGTGTACT -> AAAGCTCTCCCGTGTACTT
CAAATCACTCGAGAGGAGA -> AAATCACTCGAGAGGAGAA
CAAATTAGGCACGCCATTT -> AAATTAGGCACGCCATTTA
CAACAAGATCTGGTAACAT -> AACAAGATCTGGTAACATG
CAACGTGGACTAAGTGAGT -> AACGTGGACTAAGTGAGTT
CAACGTGTCGCGCTTGTCC -> AACGTGTCGCGCTTGTCCA
CAACTCCTTCCGAACGGTG -> AACTCCTTCCGAACGGTGT
CAACTGTTCTCAAATTAGG -> AACTGTTCTCAAATTAGGC
CAACTTCCGGACTAAATTC -> AACTTCCGGACTAAATTCC
CAAGAGCCGGATGGATCCC -> AAGAGCCGGATGGATCCCG
CAAGATACGACAATTCGTC -> AAGATACGACAATTCGTCT
CAAGATCTGGTAACATGCC -> AAGATCTGGTAACATGCCC
CAAGGGGGACCTAAGGTAA -> AAGGGGGACCTAAGGTAAT
CAAGGTTCGGTACGGGCGT -> AAGGTTCGGTACGGGCGTT
CAAGTTCGTAAGTCTTGAG -> AAGTTCGTAAGTCTTGAGG
CAATAACGAGACACTCTAC -> AATAACGAGACACTCTACG
CAATACGGGCGTCGACGAA -> AATACGGGCGTCGACGAAA
CAATAGTACCGACCTGGTA -> AATAGTACCGACCTGGTAA
CAATGCAGGCCCTCAACGT -> AATGCAGGCCCTCAACGTG
CAATGTCGCGCTTGTCCAA -> AATGTCGCGCTTGTCCAAA
CAATGTGGTTTTTCCCGGG -> AATGTGGTTTTTCCCGGGA
CAATTCGTCTTGATCTGCG -> AATTCGTCTTGATCTGCGT
CAATTTACCCCGGTGTCTT -> AATTTACCCCGGTGTCTTC
CACAAAACAGACATCTTTC -> ACAAAACAGACATCTTTCG
CACAAATCACTCGAGAGGA -> ACAAATCACTCGAGAGGAG
CACAACTTCCGGACTAAAT -> ACAACTTCCGGACTAAATT
CACAATTTACCCCGGTGTC -> ACAATTTACCCCGGTGTCT
CACACGAACTCTCGCCACT -> ACACGAACTCTCGCCACTG
CACAGCTTGGTATTTTGAA -> ACAGCTTGGTATTTTGAAC
CACAGTGTCACTATCCCCG -> ACAGTGTCACTATCCCCGG
CACAGTTCTTATCGTCGAA -> ACAGTTCTTATCGTCGAAG
CACATGGTAGCCCCACAAA -> ACATGGTAGCCCCACAAAA
CACCACCGGAGGTATATCA -> ACCACCGGAGGTATATCAA
CACCATCAAGTTCGTAAGT -> ACCATCAAGTTCGTAAGTC
CACCATCGCCACGGTCGAG -> ACCATCGCCACGGTCGAGA
CACCCCGGTAACACCACCG -> ACCCCGGTAACACCACCGG
CACCGGAGGTATATCAAAG -> ACCGGAGGTATATCAAAGC
CACCGGCGATGGGTGAGCT -> ACCGGCGATGGGTGAGCTC
CACGAACTCTCGCCACTGG -> ACGAACTCTCGCCACTGGT
CACGCCATTTAAATACGTT -> ACGCCATTTAAATACGTTA
CACGGCATCTATGGTACAG -> ACGGCATCTATGGTACAGG
CACGGTCCTAGGAGCCTTT -> ACGGTCCTAGGAGCCTTTG
CACGGTCGAGAGCGTTTAT -> ACGGTCGAGAGCGTTTATC
CACGGTGGATCGTTGCGCA -> ACGGTGGATCGTTGCGCAC
CACGTGGAGAACGGGTTCC -> ACGTGGAGAACGGGTTCCT
CACTATCCCCGGAGGCCTA -> ACTATCCCCGGAGGCCTAT
CACTCAGACCAGCGTAGGT -> ACTCAGACCAGCGTAGGTG
CACTCGAGAGGAGAAGCTT -> ACTCGAGAGGAGAAGCTTG
CACTCTACGTTAATATATT -> ACTCTACGTTAATATATTC
CACTGGTGTCTACTTTATG -> ACTGGTGTCTACTTTATGA
CACTTCCGAATCCATTCAC -> ACTTCCGAATCCATTCACG
CACTTCGAACACGGTCCTA -> ACTTCGAACACGGTCCTAG
CACTTTTTTGACAGCATTT -> ACTTTTTTGACAGCATTTG
CAGAAGGGAGTGAGCCCCC -> AGAAGGGAGTGAGCCCCCG
CAGACATCTTTCGACCGTA -> AGACATCTTTCGACCGTAC
CAGACCAGCGTAGGTGTGA -> AGACCAGCGTAGGTGTGAT
CAGACTCTGAGACCCCTGT -> AGACTCTGAGACCCCTGTG
CAGAGACGAGTAATCACTT -> AGAGACGAGTAATCACTTC
CAGATTGGCTGTATAGGCC -> AGATTGGCTGTATAGGCCA
CAGCACTCAGACCAGCGTA -> AGCACTCAGACCAGCGTAG
CAGCAGTGTCATAGTTATT -> AGCAGTGTCATAGTTATTT
CAGCAGTTCTACTAATTCT -> AGCAGTTCTACTAATTCTC
CAGCATTTGTTGCAGATTG -> AGCATTTGTTGCAGATTGG
CAGCATTTGTTGCCAGGGC -> AGCATTTGTTGCCAGGGCT
CAGCATTTGTTGGCGGCGT -> AGCATTTGTTGGCGGCGTC
CAGCATTTGTTGGCTAGGG -> AGCATTTGTTGGCTAGGGT
CAGCCCTTACACCGGCGAT -> AGCCCTTACACCGGCGATG
CAGCCGTCTTAGGGCGACA -> AGCCGTCTTAGGGCGACAG
CAGCGCGTTTAGGGCCAAA -> AGCGCGTTTAGGGCCAAAC
CAGCGCTCGATCCGAGCCC -> AGCGCTCGATCCGAGCCCT
CAGCGGGCACGTGGAGAAC -> AGCGGGCACGTGGAGAACG
CAGCGTAGGTGTGATGGAT -> AGCGTAGGTGTGATGGATG
CAGCTCGAGCCCCAAGGGG -> AGCTCGAGCCCCAAGGGGG
CAGCTGAGGTTATACAGCA -> AGCTGAGGTTATACAGCAG
CAGCTGCCGTCATTTTTGA -> AGCTGCCGTCATTTTTGAC
CAGCTTGGTATTTTGAACT -> AGCTTGGTATTTTGAACTG
CAGGACTTTTTGACAGCAT -> AGGACTTTTTGACAGCATT
CAGGCCCTCAACGTGTCGC -> AGGCCCTCAACGTGTCGCG
CAGGCTCCCGTGGCAATAA -> AGGCTCCCGTGGCAATAAC
CAGGGCTGTTACGTTTACG -> AGGGCTGTTACGTTTACGT
CAGGGTGATATTTTTAACT -> AGGGTGATATTTTTAACTG
CAGGTCCAAGATACGACAA -> AGGTCCAAGATACGACAAT
CAGGTGTGACTACTAGATT -> AGGTGTGACTACTAGATTG
CAGTCAATGTGGTTTTTCC -> AGTCAATGTGGTTTTTCCC
CAGTCCTAGAGGAACAATA -> AGTCCTAGAGGAACAATAG
CAGTGAACACGGCATCTAT -> AGTGAACACGGCATCTATG
CAGTGTCACTATCCCCGGA -> AGTGTCACTATCCCCGGAG
CAGTGTCATAGTTATTTGT -> AGTGTCATAGTTATTTGTC
CAGTGTGAAGAGTGAACGT -> AGTGTGAAGAGTGAACGTT
CAGTTCAATACGGGCGTCG -> AGTTCAATACGGGCGTCGA
CAGTTCTACTAATTCTCGA -> AGTTCTACTAATTCTCGAG
CAGTTCTTATCGTCGAAGG -> AGTTCTTATCGTCGAAGGG
CAGTTTAAAACTAGTCTCA -> AGTTTAAAACTAGTCTCAT
CATAAAACACAGTGTCACT -> ATAAAACACAGTGTCACTA
CATAGACTGTTATGAACAC -> ATAGACTGTTATGAACACT
CATAGTTATTTGTCCGTAC -> ATAGTTATTTGTCCGTACC
CATATAATAAGACCACAAT -> ATATAATAAGACCACAATT
CATATGATCATCTGACAGC -> ATATGATCATCTGACAGCG
CATCAAGTTCGTAAGTCTT -> ATCAAGTTCGTAAGTCTTG
CATCCTCTTGATATGTTAG -> ATCCTCTTGATATGTTAGG
CATCGCCACGGTCGAGAGC -> ATCGCCACGGTCGAGAGCG
CATCGCGACTTTGCCGTCC -> ATCGCGACTTTGCCGTCCG
CATCTATGGTACAGGTCCA -> ATCTATGGTACAGGTCCAA
CATCTGACAGCGCTCGATC -> ATCTGACAGCGCTCGATCC
CATCTGCGTAGCTTCGGTC -> ATCTGCGTAGCTTCGGTCT
CATCTGGGGTGATAACCGG -> ATCTGGGGTGATAACCGGG
CATCTTTCGACCGTACCTC -> ATCTTTCGACCGTACCTCT
CATGCCCACCATCAAGTTC -> ATGCCCACCATCAAGTTCG
CATGGGGGACATAGACTGT -> ATGGGGGACATAGACTGTT
CATGGTAGCCCCACAAAAC -> ATGGTAGCCCCACAAAACA
CATTAAAACGCTCAGTGTG -> ATTAAAACGCTCAGTGTGA
CATTAGTGCCAGAGACGAG -> ATTAGTGCCAGAGACGAGT
CATTCACGGTGGATCGTTG -> ATTCACGGTGGATCGTTGC
CATTGTACCCATTAGTGCC -> ATTGTACCCATTAGTGCCA
CATTTAAATACGTTATGGC -> ATTTAAATACGTTATGGCC
CATTTCCTTCATCCTCTTG -> ATTTCCTTCATCCTCTTGA
CATTTCTATGTGTTTAGCG -> ATTTCTATGTGTTTAGCGG
CATTTGTTGCAGATTGGCT -> ATTTGTTGCAGATTGGCTG
CATTTGTTGCCAGGGCTGT -> ATTTGTTGCCAGGGCTGTT
CATTTGTTGGCGGCGTCAT -> ATTTGTTGGCGGCGTCATA
CATTTGTTGGCTAGGGTGC -> ATTTGTTGGCTAGGGTGCG
CATTTTTGACAGCATTTGT -> ATTTTTGACAGCATTTGTT
CCAAACAGCTGCCGTCATT -> CAAACAGCTGCCGTCATTT
CCAAACCTACGCAGGACTT -> CAAACCTACGCAGGACTTT
CCAAACGAGGTCTAACCTT -> CAAACGAGGTCTAACCTTT
CCAAACTAAACTATTACAA -> CAAACTAAACTATTACAAG
CCAAACTACTTTCCACTTT -> CAAACTACTTTCCACTTTT
CCAAGATACGACAATTCGT -> CAAGATACGACAATTCGTC
CCAAGGGGGACCTAAGGTA -> CAAGGGGGACCTAAGGTAA
CCACAAAACAGACATCTTT -> CACAAAACAGACATCTTTC
CCACAATTTACCCCGGTGT -> CACAATTTACCCCGGTGTC
CCACCATCAAGTTCGTAAG -> CACCATCAAGTTCGTAAGT
CCACCGGAGGTATATCAAA -> CACCGGAGGTATATCAAAG
CCACGGTCGAGAGCGTTTA -> CACGGTCGAGAGCGTTTAT
CCACTGGTGTCTACTTTAT -> CACTGGTGTCTACTTTATG
CCACTTTTTTGACAGCATT -> CACTTTTTTGACAGCATTT
CCAGAAGGGAGTGAGCCCC -> CAGAAGGGAGTGAGCCCCC
CCAGACTCTGAGACCCCTG -> CAGACTCTGAGACCCCTGT
CCAGAGACGAGTAATCACT -> CAGAGACGAGTAATCACTT
CCAGCCGTCTTAGGGCGAC -> CAGCCGTCTTAGGGCGACA
CCAGCGTAGGTGTGATGGA -> CAGCGTAGGTGTGATGGAT
CCAGCTCGAGCCCCAAGGG -> CAGCTCGAGCCCCAAGGGG
CCAGCTGAGGTTATACAGC -> CAGCTGAGGTTATACAGCA
CCAGGCTCCCGTGGCAATA -> CAGGCTCCCGTGGCAATAA
CCAGGGCTGTTACGTTTAC -> CAGGGCTGTTACGTTTACG
CCAGGTGTGACTACTAGAT -> CAGGTGTGACTACTAGATT
CCATCAAGTTCGTAAGTCT -> CATCAAGTTCGTAAGTCTT
CCATCGCCACGGTCGAGAG -> CATCGCCACGGTCGAGAGC
CCATCGCGACTTTGCCGTC -> CATCGCGACTTTGCCGTCC
CCATGGGGGACATAGACTG -> CATGGGGGACATAGACTGT
CCATTAGTGCCAGAGACGA -> CATTAGTGCCAGAGACGAG
CCATTCACGGTGGATCGTT -> CATTCACGGTGGATCGTTG
CCATTTAAATACGTTATGG -> CATTTAAATACGTTATGGC
CCCAAGGGGGACCTAAGGT -> CCAAGGGGGACCTAAGGTA
CCCACAAAACAGACATCTT -> CCACAAAACAGACATCTTT
CCCACCATCAAGTTCGTAA -> CCACCATCAAGTTCGTAAG
CCCAGAAGGGAGTGAGCCC -> CCAGAAGGGAGTGAGCCCC
CCCAGGTGTGACTACTAGA -> CCAGGTGTGACTACTAGAT
CCCATTAGTGCCAGAGACG -> CCATTAGTGCCAGAGACGA
CCCCAAGGGGGACCTAAGG -> CCCAAGGGGGACCTAAGGT
CCCCACAAAACAGACATCT -> CCCACAAAACAGACATCTT
CCCCCGCGCAGCACTCAGA -> CCCCGCGCAGCACTCAGAC
CCCCGCGCAGCACTCAGAC -> CCCGCGCAGCACTCAGACC
CCCCGGAGGCCTATAAGTC -> CCCGGAGGCCTATAAGTCA
CCCCGGTAACACCACCGGA -> CCCGGTAACACCACCGGAG
CCCCGGTGTCTTCGCAGTG -> CCCGGTGTCTTCGCAGTGA
CCCCTGTGGATCATCTGGG -> CCCTGTGGATCATCTGGGG
CCCGAGCAACTCCTTCCGA -> CCGAGCAACTCCTTCCGAA
CCCGCAGTTCAATACGGGC -> CCGCAGTTCAATACGGGCG
CCCGCGCAGCACTCAGACC -> CCGCGCAGCACTCAGACCA
CCCGCTCCTTTCAGCGGGC -> CCGCTCCTTTCAGCGGGCA
CCCGGAGGCCTATAAGTCA -> CCGGAGGCCTATAAGTCAT
CCCGGCTAGAAGTGTGCTG -> CCGGCTAGAAGTGTGCTGG
CCCGGGATGCCTTCTGCTG -> CCGGGATGCCTTCTGCTGG
CCCGGTAACACCACCGGAG -> CCGGTAACACCACCGGAGG
CCCGGTGTCTTCGCAGTGA -> CCGGTGTCTTCGCAGTGAA
CCCGTGGCAATAACGAGAC -> CCGTGGCAATAACGAGACA
CCCGTGTACTTTGATTGCA -> CCGTGTACTTTGATTGCAG
CCCGTTGTATATGGATGCA -> CCGTTGTATATGGATGCAT
CCCTACTGTCGCGCTTGTC -> CCTACTGTCGCGCTTGTCC
CCCTCAACGTGTCGCGCTT -> CCTCAACGTGTCGCGCTTG
CCCTCGTATCGACTTAACA -> CCTCGTATCGACTTAACAT
CCCTGCTTCACCATCGCCA -> CCTGCTTCACCATCGCCAC
CCCTGGAGTGTACACCCCG -> CCTGGAGTGTACACCCCGG
CCCTGTGGATCATCTGGGG -> CCTGTGGATCATCTGGGGT
CCCTTACACCGGCGATGGG -> CCTTACACCGGCGATGGGT
CCGAACATTAAAACGCTCA -> CGAACATTAAAACGCTCAG
CCGAACGGTGTACCCTGGA -> CGAACGGTGTACCCTGGAG
CCGAAGCCCTGCTTCACCA -> CGAAGCCCTGCTTCACCAT
CCGAATCCATTCACGGTGG -> CGAATCCATTCACGGTGGA
CCGACCTGGTAAAGAGGCC -> CGACCTGGTAAAGAGGCCA
CCGAGCAACTCCTTCCGAA -> CGAGCAACTCCTTCCGAAC
CCGAGCCCTACTGTCGCGC -> CGAGCCCTACTGTCGCGCT
CCGAGTGTCTCTGTAAGCC -> CGAGTGTCTCTGTAAGCCG
CCGATTGCGGTGGAATGAG -> CGATTGCGGTGGAATGAGG
CCGCAGTTCAATACGGGCG -> CGCAGTTCAATACGGGCGT
CCGCGAAATAACAATGCAG -> CGCGAAATAACAATGCAGG
CCGCGCAGCACTCAGACCA -> CGCGCAGCACTCAGACCAG
CCGCTCCTTTCAGCGGGCA -> CGCTCCTTTCAGCGGGCAC
CCGGACTAAATTCCCAGAA -> CGGACTAAATTCCCAGAAG
CCGGAGGCCTATAAGTCAT -> CGGAGGCCTATAAGTCATA
CCGGAGGTATATCAAAGCT -> CGGAGGTATATCAAAGCTC
CCGGATGGATCCCGCAGTT -> CGGATGGATCCCGCAGTTC
CCGGCGATGGGTGAGCTCA -> CGGCGATGGGTGAGCTCAC
CCGGCTAGAAGTGTGCTGG -> CGGCTAGAAGTGTGCTGGC
CCGGGATGCCTTCTGCTGG -> CGGGATGCCTTCTGCTGGC
CCGGGGCGAGGGTCGGTGT -> CGGGGCGAGGGTCGGTGTG
CCGGTAACACCACCGGAGG -> CGGTAACACCACCGGAGGT
CCGGTATCTAAGTCGGCTG -> CGGTATCTAAGTCGGCTGA
CCGGTGCAGCCCTTACACC -> CGGTGCAGCCCTTACACCG
CCGGTGTCTTCGCAGTGAA -> CGGTGTCTTCGCAGTGAAC
CCGGTTCGTGTCGCGGTAC -> CGGTTCGTGTCGCGGTACT
CCGTACCCGCTCCTTTCAG -> CGTACCCGCTCCTTTCAGC
CCGTACCTCTAATGGCTGG -> CGTACCTCTAATGGCTGGC
CCGTCATTTTTGACAGCAT -> CGTCATTTTTGACAGCATT
CCGTCCGTCGGCTGGAGGT -> CGTCCGTCGGCTGGAGGTA
CCGTCGGCTGGAGGTACGG -> CGTCGGCTGGAGGTACGGT
CCGTCTTAGGGCGACAGCA -> CGTCTTAGGGCGACAGCAG
CCGTGGCAATAACGAGACA -> CGTGGCAATAACGAGACAC
CCGTGTACTTTGATTGCAG -> CGTGTACTTTGATTGCAGT
CCGTTGTATATGGATGCAT -> CGTTGTATATGGATGCATT
CCTAAGGTAATAGCCTCGG -> CTAAGGTAATAGCCTCGGG
CCTACGCAGGACTTTTTGA -> CTACGCAGGACTTTTTGAC
CCTACTGACTGACTCGCTC -> CTACTGACTGACTCGCTCA
CCTACTGTCGCGCTTGTCC -> CTACTGTCGCGCTTGTCCA
CCTAGAGGAACAATAGTAC -> CTAGAGGAACAATAGTACC
CCTAGGAGAACGCTAGTGT -> CTAGGAGAACGCTAGTGTA
CCTAGGAGCCTTTGTCGTT -> CTAGGAGCCTTTGTCGTTA
CCTATAAGTCATATGATCA -> CTATAAGTCATATGATCAT
CCTATCGGCCGAAGCCCTG -> CTATCGGCCGAAGCCCTGC
CCTATGATGATGGGTCATC -> CTATGATGATGGGTCATCT
CCTCAACGTGTCGCGCTTG -> CTCAACGTGTCGCGCTTGT
CCTCAACTGTTCTCAAATT -> CTCAACTGTTCTCAAATTA
CCTCGGGACTAGCCGGTAT -> CTCGGGACTAGCCGGTATC
CCTCGTATCGACTTAACAT -> CTCGTATCGACTTAACATT
CCTCTAATGGCTGGCTCTC -> CTCTAATGGCTGGCTCTCA
CCTCTGACCCTCGTATCGA -> CTCTGACCCTCGTATCGAC
CCTCTTGATATGTTAGGGC -> CTCTTGATATGTTAGGGCA
CCTGCTTCACCATCGCCAC -> CTGCTTCACCATCGCCACG
CCTGGAGTGTACACCCCGG -> CTGGAGTGTACACCCCGGT
CCTGGTAAAGAGGCCAGCC -> CTGGTAAAGAGGCCAGCCG
CCTGTGGATCATCTGGGGT -> CTGTGGATCATCTGGGGTG
CCTTACACCGGCGATGGGT -> CTTACACCGGCGATGGGTG
CCTTCATCCTCTTGATATG -> CTTCATCCTCTTGATATGT
CCTTCCGAACGGTGTACCC -> CTTCCGAACGGTGTACCCT
CCTTCTGCTGGCTTACGTG -> CTTCTGCTGGCTTACGTGG
CCTTTATCCAGACTCTGAG -> CTTTATCCAGACTCTGAGA
CCTTTCAGCGGGCACGTGG -> CTTTCAGCGGGCACGTGGA
CCTTTGTCGTTATTAGGGG -> CTTTGTCGTTATTAGGGGG
CCTTTTTGACAGCATTTGT -> CTTTTTGACAGCATTTGTT
CGAAAATAACCTCTGACCC -> GAAAATAACCTCTGACCCT
CGAAATAACAATGCAGGCC -> GAAATAACAATGCAGGCCC
CGAAATCGGGACACACGAA -> GAAATCGGGACACACGAAC
CGAACACGGTCCTAGGAGC -> GAACACGGTCCTAGGAGCC
CGAACATTAAAACGCTCAG -> GAACATTAAAACGCTCAGT
CGAACGGTGTACCCTGGAG -> GAACGGTGTACCCTGGAGT
CGAACTCTCGCCACTGGTG -> GAACTCTCGCCACTGGTGT
CGAAGCCCTGCTTCACCAT -> GAAGCCCTGCTTCACCATC
CGAAGGGGTGAGTATATTT -> GAAGGGGTGAGTATATTTA
CGAATCCATTCACGGTGGA -> GAATCCATTCACGGTGGAT
CGACAATTCGTCTTGATCT -> GACAATTCGTCTTGATCTG
CGACAGCAGTGTCATAGTT -> GACAGCAGTGTCATAGTTA
CGACCCGGCTAGAAGTGTG -> GACCCGGCTAGAAGTGTGC
CGACCGTACCTCTAATGGC -> GACCGTACCTCTAATGGCT
CGACCTGGTAAAGAGGCCA -> GACCTGGTAAAGAGGCCAG
CGACGAAATCGGGACACAC -> GACGAAATCGGGACACACG
CGACTTAACATTTCCTTCA -> GACTTAACATTTCCTTCAT
CGACTTTGCCGTCCGTCGG -> GACTTTGCCGTCCGTCGGC
CGAGACACTCTACGTTAAT -> GAGACACTCTACGTTAATA
CGAGAGCGTTTATCCATGG -> GAGAGCGTTTATCCATGGG
CGAGAGGAGAAGCTTGGAT -> GAGAGGAGAAGCTTGGATG
CGAGATAATACATAAAACA -> GAGATAATACATAAAACAC
CGAGCAACTCCTTCCGAAC -> GAGCAACTCCTTCCGAACG
CGAGCCCCAAGGGGGACCT -> GAGCCCCAAGGGGGACCTA
CGAGCCCTACTGTCGCGCT -> GAGCCCTACTGTCGCGCTT
CGAGGGTCGGTGTGTTAGA -> GAGGGTCGGTGTGTTAGAT
CGAGGTCTAACCTTTTTGA -> GAGGTCTAACCTTTTTGAC
CGAGTAATCACTTCGAACA -> GAGTAATCACTTCGAACAC
CGAGTCGGCCCGAGCAACT -> GAGTCGGCCCGAGCAACTC
CGAGTGTCTCTGTAAGCCG -> GAGTGTCTCTGTAAGCCGG
CGATCCGAGCCCTACTGTC -> GATCCGAGCCCTACTGTCG
CGATGGGTGAGCTCACAAA -> GATGGGTGAGCTCACAAAT
CGATTGCGGTGGAATGAGG -> GATTGCGGTGGAATGAGGT
CGCACAACTTCCGGACTAA -> GCACAACTTCCGGACTAAA
CGCAGCACTCAGACCAGCG -> GCAGCACTCAGACCAGCGT
CGCAGGACTTTTTGACAGC -> GCAGGACTTTTTGACAGCA
CGCAGTGAACACGGCATCT -> GCAGTGAACACGGCATCTA
CGCAGTTCAATACGGGCGT -> GCAGTTCAATACGGGCGTC
CGCCACGGTCGAGAGCGTT -> GCCACGGTCGAGAGCGTTT
CGCCACTGGTGTCTACTTT -> GCCACTGGTGTCTACTTTA
CGCCATTTAAATACGTTAT -> GCCATTTAAATACGTTATG
CGCCGATTGCGGTGGAATG -> GCCGATTGCGGTGGAATGA
CGCCTTTATCCAGACTCTG -> GCCTTTATCCAGACTCTGA
CGCGAAATAACAATGCAGG -> GCGAAATAACAATGCAGGC
CGCGACTTTGCCGTCCGTC -> GCGACTTTGCCGTCCGTCG
CGCGCAGCACTCAGACCAG -> GCGCAGCACTCAGACCAGC
CGCGCCTTTATCCAGACTC -> GCGCCTTTATCCAGACTCT
CGCGCTTGTCCAAACAGCT -> GCGCTTGTCCAAACAGCTG
CGCGCTTGTCCAAACCTAC -> GCGCTTGTCCAAACCTACG
CGCGCTTGTCCAAACGAGG -> GCGCTTGTCCAAACGAGGT
CGCGCTTGTCCAAACTACT -> GCGCTTGTCCAAACTACTT
CGCGGTACTCCGAACATTA -> GCGGTACTCCGAACATTAA
CGCGTGACGTCGGGACGCC -> GCGTGACGTCGGGACGCCG
CGCGTTTAGGGCCAAACTA -> GCGTTTAGGGCCAAACTAA
CGCTAGTGTATTTGTCGCG -> GCTAGTGTATTTGTCGCGC
CGCTCACATGGTAGCCCCA -> GCTCACATGGTAGCCCCAC
CGCTCAGTCCTAGAGGAAC -> GCTCAGTCCTAGAGGAACA
CGCTCAGTGTGAAGAGTGA -> GCTCAGTGTGAAGAGTGAA
CGCTCCTTTCAGCGGGCAC -> GCTCCTTTCAGCGGGCACG
CGCTCGATCCGAGCCCTAC -> GCTCGATCCGAGCCCTACT
CGCTTGTCCAAACAGCTGC -> GCTTGTCCAAACAGCTGCC
CGCTTGTCCAAACCTACGC -> GCTTGTCCAAACCTACGCA
CGCTTGTCCAAACGAGGTC -> GCTTGTCCAAACGAGGTCT
CGCTTGTCCAAACTACTTT -> GCTTGTCCAAACTACTTTC
CGGACTAAATTCCCAGAAG -> GGACTAAATTCCCAGAAGG
CGGAGAAACCGCGAAATAA -> GGAGAAACCGCGAAATAAC
CGGAGGCCTATAAGTCATA -> GGAGGCCTATAAGTCATAT
CGGAGGTATATCAAAGCTC -> GGAGGTATATCAAAGCTCT
CGGATGGATCCCGCAGTTC -> GGATGGATCCCGCAGTTCA
CGGCATCTATGGTACAGGT -> GGCATCTATGGTACAGGTC
CGGCCCGAGCAACTCCTTC -> GGCCCGAGCAACTCCTTCC
CGGCCGAAGCCCTGCTTCA -> GGCCGAAGCCCTGCTTCAC
CGGCGATGGGTGAGCTCAC -> GGCGATGGGTGAGCTCACA
CGGCGTCATATAATAAGAC -> GGCGTCATATAATAAGACC
CGGCTAGAAGTGTGCTGGC -> GGCTAGAAGTGTGCTGGCA
CGGCTGATCCTCAACTGTT -> GGCTGATCCTCAACTGTTC
CGGCTGGAGGTACGGTGTA -> GGCTGGAGGTACGGTGTAA
CGGGACACACGAACTCTCG -> GGGACACACGAACTCTCGC
CGGGACGCCGATTGCGGTG -> GGGACGCCGATTGCGGTGG
CGGGACTAGCCGGTATCTA -> GGGACTAGCCGGTATCTAA
CGGGATGCCTTCTGCTGGC -> GGGATGCCTTCTGCTGGCT
CGGGCAACAAGATCTGGTA -> GGGCAACAAGATCTGGTAA
CGGGCACGTGGAGAACGGG -> GGGCACGTGGAGAACGGGT
CGGGCGTCGACGAAATCGG -> GGGCGTCGACGAAATCGGG
CGGGCGTTCGGGCAACAAG -> GGGCGTTCGGGCAACAAGA
CGGGGCGAGGGTCGGTGTG -> GGGGCGAGGGTCGGTGTGT
CGGGTTCCTATGATGATGG -> GGGTTCCTATGATGATGGG
CGGTAACACCACCGGAGGT -> GGTAACACCACCGGAGGTA
CGGTACGGGCGTTCGGGCA -> GGTACGGGCGTTCGGGCAA
CGGTACTCCGAACATTAAA -> GGTACTCCGAACATTAAAA
CGGTATCTAAGTCGGCTGA -> GGTATCTAAGTCGGCTGAT
CGGTCCTAGGAGCCTTTGT -> GGTCCTAGGAGCCTTTGTC
CGGTCGAGAGCGTTTATCC -> GGTCGAGAGCGTTTATCCA
CGGTCTTGTTCGCGTGACG -> GGTCTTGTTCGCGTGACGT
CGGTGCAGCCCTTACACCG -> GGTGCAGCCCTTACACCGG
CGGTGCCAGGCTCCCGTGG -> GGTGCCAGGCTCCCGTGGC
CGGTGGAATGAGGTGTTCC -> GGTGGAATGAGGTGTTCCC
CGGTGGATCGTTGCGCACA -> GGTGGATCGTTGCGCACAA
CGGTGTAAATCACAGCTTG -> GGTGTAAATCACAGCTTGG
CGGTGTACCCTGGAGTGTA -> GGTGTACCCTGGAGTGTAC
CGGTGTCTTCGCAGTGAAC -> GGTGTCTTCGCAGTGAACA
CGGTGTGTTAGATCTCACA -> GGTGTGTTAGATCTCACAG
CGGTTCGTGTCGCGGTACT -> GGTTCGTGTCGCGGTACTC
CGTAAGTCTTGAGGATGTT -> GTAAGTCTTGAGGATGTTG
CGTACCCGCTCCTTTCAGC -> GTACCCGCTCCTTTCAGCG
CGTACCTCTAATGGCTGGC -> GTACCTCTAATGGCTGGCT
CGTAGCTTCGGTCTTGTTC -> GTAGCTTCGGTCTTGTTCG
CGTAGGTGTGATGGATGAT -> GTAGGTGTGATGGATGATA
CGTATCGACTTAACATTTC -> GTATCGACTTAACATTTCC
CGTCATATAATAAGACCAC -> GTCATATAATAAGACCACA
CGTCATTTTTGACAGCATT -> GTCATTTTTGACAGCATTT
CGTCCGTCGGCTGGAGGTA -> GTCCGTCGGCTGGAGGTAC
CGTCCTACTGACTGACTCG -> GTCCTACTGACTGACTCGC
CGTCGAAGGGGTGAGTATA -> GTCGAAGGGGTGAGTATAT
CGTCGACGAAATCGGGACA -> GTCGACGAAATCGGGACAC
CGTCGGCTGGAGGTACGGT -> GTCGGCTGGAGGTACGGTG
CGTCGGGACGCCGATTGCG -> GTCGGGACGCCGATTGCGG
CGTCTTAGGGCGACAGCAG -> GTCTTAGGGCGACAGCAGT
CGTCTTGATCTGCGTCCTA -> GTCTTGATCTGCGTCCTAC
CGTGACGTCGGGACGCCGA -> GTGACGTCGGGACGCCGAT
CGTGGACTAAGTGAGTTAT -> GTGGACTAAGTGAGTTATG
CGTGGAGAACGGGTTCCTA -> GTGGAGAACGGGTTCCTAT
CGTGGCAATAACGAGACAC -> GTGGCAATAACGAGACACT
CGTGGTAGAATAACCATCG -> GTGGTAGAATAACCATCGC
CGTGTACTTTGATTGCAGT -> GTGTACTTTGATTGCAGTT
CGTGTCGCGCTTGTCCAAA -> GTGTCGCGCTTGTCCAAAC
CGTGTCGCGGTACTCCGAA -> GTGTCGCGGTACTCCGAAC
CGTTAAGCGTTGAGACTTC -> GTTAAGCGTTGAGACTTCA
CGTTAATATATTCTAGTCA -> GTTAATATATTCTAGTCAG
CGTTAGTGCGAAAATAACC -> GTTAGTGCGAAAATAACCT
CGTTATGGCCTAGGAGAAC -> GTTATGGCCTAGGAGAACG
CGTTATTAGGGGGTTGATT -> GTTATTAGGGGGTTGATTT
CGTTCGGGCAACAAGATCT -> GTTCGGGCAACAAGATCTG
CGTTGAGACTTCAAGGTTC -> GTTGAGACTTCAAGGTTCG
CGTTGCGCACAACTTCCGG -> GTTGCGCACAACTTCCGGA
CGTTGTATATGGATGCATT -> GTTGTATATGGATGCATTT
CGTTTACGTTAAGCGTTGA -> GTTTACGTTAAGCGTTGAG
CGTTTAGGGCCAAACTAAA -> GTTTAGGGCCAAACTAAAC
CGTTTATCCAGCTCGAGCC -> GTTTATCCAGCTCGAGCCC
CGTTTATCCATGGGGGACA -> GTTTATCCATGGGGGACAT
CTAAACTATTACAAGAGCC -> TAAACTATTACAAGAGCCG
CTAAATTCCCAGAAGGGAG -> TAAATTCCCAGAAGGGAGT
CTAACCTTTTTGACAGCAT -> TAACCTTTTTGACAGCATT
CTAAGGTAATAGCCTCGGG -> TAAGGTAATAGCCTCGGGA
CTAAGTCGGCTGATCCTCA -> TAAGTCGGCTGATCCTCAA
CTAAGTGAGTTATGTTACG -> TAAGTGAGTTATGTTACGC
CTAATGGCTGGCTCTCAAT -> TAATGGCTGGCTCTCAATG
CTAATTCTCGAGATAATAC -> TAATTCTCGAGATAATACA
CTACGCAGGACTTTTTGAC -> TACGCAGGACTTTTTGACA
CTACGTTAATATATTCTAG -> TACGTTAATATATTCTAGT
CTACTAATTCTCGAGATAA -> TACTAATTCTCGAGATAAT
CTACTAGATTGCGCTCACA -> TACTAGATTGCGCTCACAT
CTACTGACTGACTCGCTCA -> TACTGACTGACTCGCTCAG
CTACTGTCGCGCTTGTCCA -> TACTGTCGCGCTTGTCCAA
CTACTTTATGAGTGATGAG -> TACTTTATGAGTGATGAGT
CTACTTTCCACTTTTTTGA -> TACTTTCCACTTTTTTGAC
CTAGAAGTCAACGTGGACT -> TAGAAGTCAACGTGGACTA
CTAGAGGAACAATAGTACC -> TAGAGGAACAATAGTACCG
CTAGATTGCGCTCACATGG -> TAGATTGCGCTCACATGGT
CTAGCCGGTATCTAAGTCG -> TAGCCGGTATCTAAGTCGG
CTAGGAGAACGCTAGTGTA -> TAGGAGAACGCTAGTGTAT
CTAGGAGCCTTTGTCGTTA -> TAGGAGCCTTTGTCGTTAT
CTAGGGTGCGGAGAAACCG -> TAGGGTGCGGAGAAACCGC
CTAGTCAGGGTGATATTTT -> TAGTCAGGGTGATATTTTT
CTAGTCTCATTGTACCCAT -> TAGTCTCATTGTACCCATT
CTAGTGTATTTGTCGCGCT -> TAGTGTATTTGTCGCGCTT
CTATAAGTCATATGATCAT -> TATAAGTCATATGATCATC
CTATCCCCGGAGGCCTATA -> TATCCCCGGAGGCCTATAA
CTATCGGCCGAAGCCCTGC -> TATCGGCCGAAGCCCTGCT
CTATGATGATGGGTCATCT -> TATGATGATGGGTCATCTG
CTATGGTACAGGTCCAAGA -> TATGGTACAGGTCCAAGAT
CTATGTGTTTAGCGGTGCC -> TATGTGTTTAGCGGTGCCA
CTATTACAAGAGCCGGATG -> TATTACAAGAGCCGGATGG
CTCAAATTAGGCACGCCAT -> TCAAATTAGGCACGCCATT
CTCAACGTGTCGCGCTTGT -> TCAACGTGTCGCGCTTGTC
CTCAACTGTTCTCAAATTA -> TCAACTGTTCTCAAATTAG
CTCAATGTCGCGCTTGTCC -> TCAATGTCGCGCTTGTCCA
CTCACAAATCACTCGAGAG -> TCACAAATCACTCGAGAGG
CTCACAGTTCTTATCGTCG -> TCACAGTTCTTATCGTCGA
CTCACATGGTAGCCCCACA -> TCACATGGTAGCCCCACAA
CTCAGACCAGCGTAGGTGT -> TCAGACCAGCGTAGGTGTG
CTCAGTCCTAGAGGAACAA -> TCAGTCCTAGAGGAACAAT
CTCAGTGTGAAGAGTGAAC -> TCAGTGTGAAGAGTGAACG
CTCATTGTACCCATTAGTG -> TCATTGTACCCATTAGTGC
CTCCCGTGGCAATAACGAG -> TCCCGTGGCAATAACGAGA
CTCCCGTGTACTTTGATTG -> TCCCGTGTACTTTGATTGC
CTCCGAACATTAAAACGCT -> TCCGAACATTAAAACGCTC
CTCCTTCCGAACGGTGTAC -> TCCTTCCGAACGGTGTACC
CTCCTTTCAGCGGGCACGT -> TCCTTTCAGCGGGCACGTG
CTCGAGAGGAGAAGCTTGG -> TCGAGAGGAGAAGCTTGGA
CTCGAGATAATACATAAAA -> TCGAGATAATACATAAAAC
CTCGAGCCCCAAGGGGGAC -> TCGAGCCCCAAGGGGGACC
CTCGATCCGAGCCCTACTG -> TCGATCCGAGCCCTACTGT
CTCGCCACTGGTGTCTACT -> TCGCCACTGGTGTCTACTT
CTCGCTCAGTCCTAGAGGA -> TCGCTCAGTCCTAGAGGAA
CTCGGGACTAGCCGGTATC -> TCGGGACTAGCCGGTATCT
CTCGTATCGACTTAACATT -> TCGTATCGACTTAACATTT
CTCTAATGGCTGGCTCTCA -> TCTAATGGCTGGCTCTCAA
CTCTACGTTAATATATTCT -> TCTACGTTAATATATTCTA
CTCTCAATGTCGCGCTTGT -> TCTCAATGTCGCGCTTGTC
CTCTCCCGTGTACTTTGAT -> TCTCCCGTGTACTTTGATT
CTCTCGCCACTGGTGTCTA -> TCTCGCCACTGGTGTCTAC
CTCTGACCCTCGTATCGAC -> TCTGACCCTCGTATCGACT
CTCTGAGACCCCTGTGGAT -> TCTGAGACCCCTGTGGATC
CTCTGTAAGCCGGTTCGTG -> TCTGTAAGCCGGTTCGTGT
CTCTTGATATGTTAGGGCA -> TCTTGATATGTTAGGGCAG
CTGACAGCGCTCGATCCGA -> TGACAGCGCTCGATCCGAG
CTGACCCTCGTATCGACTT -> TGACCCTCGTATCGACTTA
CTGACCGGTGCAGCCCTTA -> TGACCGGTGCAGCCCTTAC
CTGACTCGCTCAGTCCTAG -> TGACTCGCTCAGTCCTAGA
CTGACTGACTCGCTCAGTC -> TGACTGACTCGCTCAGTCC
CTGAGACCCCTGTGGATCA -> TGAGACCCCTGTGGATCAT
CTGAGGTTATACAGCAGTT -> TGAGGTTATACAGCAGTTC
CTGATCCTCAACTGTTCTC -> TGATCCTCAACTGTTCTCA
CTGCCGTCATTTTTGACAG -> TGCCGTCATTTTTGACAGC
CTGCGTAGCTTCGGTCTTG -> TGCGTAGCTTCGGTCTTGT
CTGCGTCCTACTGACTGAC -> TGCGTCCTACTGACTGACT
CTGCTGGCTTACGTGGTAG -> TGCTGGCTTACGTGGTAGA
CTGCTTCACCATCGCCACG -> TGCTTCACCATCGCCACGG
CTGGAGGTACGGTGTAAAT -> TGGAGGTACGGTGTAAATC
CTGGAGTGTACACCCCGGT -> TGGAGTGTACACCCCGGTA
CTGGCTCTCAATGTCGCGC -> TGGCTCTCAATGTCGCGCT
CTGGCTTACGTGGTAGAAT -> TGGCTTACGTGGTAGAATA
CTGGGGTGATAACCGGGGC -> TGGGGTGATAACCGGGGCG
CTGGGTCGACCCGGCTAGA -> TGGGTCGACCCGGCTAGAA
CTGGTAAAGAGGCCAGCCG -> TGGTAAAGAGGCCAGCCGT
CTGGTAACATGCCCACCAT -> TGGTAACATGCCCACCATC
CTGGTGTCTACTTTATGAG -> TGGTGTCTACTTTATGAGT
CTGTAAGCCGGTTCGTGTC -> TGTAAGCCGGTTCGTGTCG
CTGTATAGGCCAGCTGAGG -> TGTATAGGCCAGCTGAGGT
CTGTCGCGCTTGTCCAAAC -> TGTCGCGCTTGTCCAAACC
CTGTGGATCATCTGGGGTG -> TGTGGATCATCTGGGGTGA
CTGTTACGTTTACGTTAAG -> TGTTACGTTTACGTTAAGC
CTGTTATGAACACTTCCGA -> TGTTATGAACACTTCCGAA
CTGTTCTCAAATTAGGCAC -> TGTTCTCAAATTAGGCACG
CTTAACATTTCCTTCATCC -> TTAACATTTCCTTCATCCT
CTTACACCGGCGATGGGTG -> TTACACCGGCGATGGGTGA
CTTACGTGGTAGAATAACC -> TTACGTGGTAGAATAACCA
CTTAGGGCGACAGCAGTGT -> TTAGGGCGACAGCAGTGTC
CTTATCGTCGAAGGGGTGA -> TTATCGTCGAAGGGGTGAG
CTTCAAGGTTCGGTACGGG -> TTCAAGGTTCGGTACGGGC
CTTCACCATCGCCACGGTC -> TTCACCATCGCCACGGTCG
CTTCATCCTCTTGATATGT -> TTCATCCTCTTGATATGTT
CTTCCGAACGGTGTACCCT -> TTCCGAACGGTGTACCCTG
CTTCCGAATCCATTCACGG -> TTCCGAATCCATTCACGGT
CTTCCGGACTAAATTCCCA -> TTCCGGACTAAATTCCCAG
CTTCGAACACGGTCCTAGG -> TTCGAACACGGTCCTAGGA
CTTCGCAGTGAACACGGCA -> TTCGCAGTGAACACGGCAT
CTTCGGTCTTGTTCGCGTG -> TTCGGTCTTGTTCGCGTGA
CTTCTGCTGGCTTACGTGG -> TTCTGCTGGCTTACGTGGT
CTTGAGGATGTTGGATAGG -> TTGAGGATGTTGGATAGGA
CTTGATATGTTAGGGCAGT -> TTGATATGTTAGGGCAGTC
CTTGATCTGCGTCCTACTG -> TTGATCTGCGTCCTACTGA
CTTGGATGTAATATCGAGT -> TTGGATGTAATATCGAGTC
CTTGGTATTTTGAACTGGG -> TTGGTATTTTGAACTGGGT
CTTGTCCAAACAGCTGCCG -> TTGTCCAAACAGCTGCCGT
CTTGTCCAAACCTACGCAG -> TTGTCCAAACCTACGCAGG
CTTGTCCAAACGAGGTCTA -> TTGTCCAAACGAGGTCTAA
CTTGTCCAAACTACTTTCC -> TTGTCCAAACTACTTTCCA
CTTGTTCGCGTGACGTCGG -> TTGTTCGCGTGACGTCGGG
CTTTATCCAGACTCTGAGA -> TTTATCCAGACTCTGAGAC
CTTTATGAGTGATGAGTGA -> TTTATGAGTGATGAGTGAC
CTTTCAGCGGGCACGTGGA -> TTTCAGCGGGCACGTGGAG
CTTTCCACTTTTTTGACAG -> TTTCCACTTTTTTGACAGC
CTTTCGACCGTACCTCTAA -> TTTCGACCGTACCTCTAAT
CTTTGATTGCAGTTTAAAA -> TTTGATTGCAGTTTAAAAC
CTTTGCCGTCCGTCGGCTG -> TTTGCCGTCCGTCGGCTGG
CTTTGTCGTTATTAGGGGG -> TTTGTCGTTATTAGGGGGT
CTTTTTGACAGCATTTGTT -> TTTTTGACAGCATTTGTTG,TTTTTGACAGCATTTGTTG
CTTTTTTGACAGCATTTGT -> TTTTTTGACAGCATTTGTT
GAAAATAACCTCTGACCCT -> AAAATAACCTCTGACCCTC
GAAACCGCGAAATAACAAT -> AAACCGCGAAATAACAATG
GAAATAACAATGCAGGCCC -> AAATAACAATGCAGGCCCT
GAAATCGGGACACACGAAC -> AAATCGGGACACACGAACT
GAACAATAGTACCGACCTG -> AACAATAGTACCGACCTGG
GAACACGGCATCTATGGTA -> AACACGGCATCTATGGTAC
GAACACGGTCCTAGGAGCC -> AACACGGTCCTAGGAGCCT
GAACACTTCCGAATCCATT -> AACACTTCCGAATCCATTC
GAACATTAAAACGCTCAGT -> AACATTAAAACGCTCAGTG
GAACGCTAGTGTATTTGTC -> AACGCTAGTGTATTTGTCG
GAACGGGTTCCTATGATGA -> AACGGGTTCCTATGATGAT
GAACGGTGTACCCTGGAGT -> AACGGTGTACCCTGGAGTG
GAACGTTAGTGCGAAAATA -> AACGTTAGTGCGAAAATAA
GAACTCTCGCCACTGGTGT -> AACTCTCGCCACTGGTGTC
GAACTGGGTCGACCCGGCT -> AACTGGGTCGACCCGGCTA
GAAGAGTGAACGTTAGTGC -> AAGAGTGAACGTTAGTGCG
GAAGCCCTGCTTCACCATC -> AAGCCCTGCTTCACCATCG
GAAGCTTGGATGTAATATC -> AAGCTTGGATGTAATATCG
GAAGGGAGTGAGCCCCCGC -> AAGGGAGTGAGCCCCCGCG
GAAGGGGTGAGTATATTTA -> AAGGGGTGAGTATATTTAA
GAAGTCAACGTGGACTAAG -> AAGTCAACGTGGACTAAGT
GAATAACCATCGCGACTTT -> AATAACCATCGCGACTTTG
GAATCCATTCACGGTGGAT -> AATCCATTCACGGTGGATC
GAATGAGGTGTTCCCGTTG -> AATGAGGTGTTCCCGTTGT
GACAATTCGTCTTGATCTG -> ACAATTCGTCTTGATCTGC
GACACACGAACTCTCGCCA -> ACACACGAACTCTCGCCAC
GACACTCTACGTTAATATA -> ACACTCTACGTTAATATAT
GACAGCAGTGTCATAGTTA -> ACAGCAGTGTCATAGTTAT
GACAGCATTTGTTGCAGAT -> ACAGCATTTGTTGCAGATT
GACAGCATTTGTTGCCAGG -> ACAGCATTTGTTGCCAGGG
GACAGCATTTGTTGGCGGC -> ACAGCATTTGTTGGCGGCG
GACAGCATTTGTTGGCTAG -> ACAGCATTTGTTGGCTAGG
GACAGCGCTCGATCCGAGC -> ACAGCGCTCGATCCGAGCC
GACATAGACTGTTATGAAC -> ACATAGACTGTTATGAACA
GACATCTTTCGACCGTACC -> ACATCTTTCGACCGTACCT
GACCACAATTTACCCCGGT -> ACCACAATTTACCCCGGTG
GACCAGCGTAGGTGTGATG -> ACCAGCGTAGGTGTGATGG
GACCCCTGTGGATCATCTG -> ACCCCTGTGGATCATCTGG
GACCCGGCTAGAAGTGTGC -> ACCCGGCTAGAAGTGTGCT
GACCCTCGTATCGACTTAA -> ACCCTCGTATCGACTTAAC
GACCGGTGCAGCCCTTACA -> ACCGGTGCAGCCCTTACAC
GACCGTACCTCTAATGGCT -> ACCGTACCTCTAATGGCTG
GACCTAAGGTAATAGCCTC -> ACCTAAGGTAATAGCCTCG
GACCTGGTAAAGAGGCCAG -> ACCTGGTAAAGAGGCCAGC
GACGAAATCGGGACACACG -> ACGAAATCGGGACACACGA
GACGAGTAATCACTTCGAA -> ACGAGTAATCACTTCGAAC
GACGCCGATTGCGGTGGAA -> ACGCCGATTGCGGTGGAAT
GACGTCGGGACGCCGATTG -> ACGTCGGGACGCCGATTGC
GACTAAATTCCCAGAAGGG -> ACTAAATTCCCAGAAGGGA
GACTAAGTGAGTTATGTTA -> ACTAAGTGAGTTATGTTAC
GACTACTAGATTGCGCTCA -> ACTACTAGATTGCGCTCAC
GACTAGAAGTCAACGTGGA -> ACTAGAAGTCAACGTGGAC
GACTAGCCGGTATCTAAGT -> ACTAGCCGGTATCTAAGTC
GACTCGCTCAGTCCTAGAG -> ACTCGCTCAGTCCTAGAGG
GACTCTGAGACCCCTGTGG -> ACTCTGAGACCCCTGTGGA
GACTGACTCGCTCAGTCCT -> ACTGACTCGCTCAGTCCTA
GACTGTTATGAACACTTCC -> ACTGTTATGAACACTTCCG
GACTTAACATTTCCTTCAT -> ACTTAACATTTCCTTCATC
GACTTCAAGGTTCGGTACG -> ACTTCAAGGTTCGGTACGG
GACTTTGCCGTCCGTCGGC -> ACTTTGCCGTCCGTCGGCT
GACTTTTTGACAGCATTTG -> ACTTTTTGACAGCATTTGT
GAGAAACCGCGAAATAACA -> AGAAACCGCGAAATAACAA
GAGAACGCTAGTGTATTTG -> AGAACGCTAGTGTATTTGT
GAGAACGGGTTCCTATGAT -> AGAACGGGTTCCTATGATG
GAGAAGCTTGGATGTAATA -> AGAAGCTTGGATGTAATAT
GAGACACTCTACGTTAATA -> AGACACTCTACGTTAATAT
GAGACCCCTGTGGATCATC -> AGACCCCTGTGGATCATCT
GAGACGAGTAATCACTTCG -> AGACGAGTAATCACTTCGA
GAGACTTCAAGGTTCGGTA -> AGACTTCAAGGTTCGGTAC
GAGAGCCGAGTGTCTCTGT -> AGAGCCGAGTGTCTCTGTA
GAGAGCGTTTATCCATGGG -> AGAGCGTTTATCCATGGGG
GAGAGGAGAAGCTTGGATG -> AGAGGAGAAGCTTGGATGT
GAGATAATACATAAAACAC -> AGATAATACATAAAACACA
GAGCAACTCCTTCCGAACG -> AGCAACTCCTTCCGAACGG
GAGCCCCAAGGGGGACCTA -> AGCCCCAAGGGGGACCTAA
GAGCCCCCGCGCAGCACTC -> AGCCCCCGCGCAGCACTCA
GAGCCCTACTGTCGCGCTT -> AGCCCTACTGTCGCGCTTG
GAGCCGAGTGTCTCTGTAA -> AGCCGAGTGTCTCTGTAAG
GAGCCGGATGGATCCCGCA -> AGCCGGATGGATCCCGCAG
GAGCCTTTGTCGTTATTAG -> AGCCTTTGTCGTTATTAGG
GAGCGTTTATCCATGGGGG -> AGCGTTTATCCATGGGGGA
GAGCTCACAAATCACTCGA -> AGCTCACAAATCACTCGAG
GAGGAACAATAGTACCGAC -> AGGAACAATAGTACCGACC
GAGGAGAAGCTTGGATGTA -> AGGAGAAGCTTGGATGTAA
GAGGATGTTGGATAGGATA -> AGGATGTTGGATAGGATAA
GAGGCCAGCCGTCTTAGGG -> AGGCCAGCCGTCTTAGGGC
GAGGCCTATAAGTCATATG -> AGGCCTATAAGTCATATGA
GAGGGTCGGTGTGTTAGAT -> AGGGTCGGTGTGTTAGATC
GAGGTACGGTGTAAATCAC -> AGGTACGGTGTAAATCACA
GAGGTATATCAAAGCTCTC -> AGGTATATCAAAGCTCTCC
GAGGTCTAACCTTTTTGAC -> AGGTCTAACCTTTTTGACA
GAGGTGTTCCCGTTGTATA -> AGGTGTTCCCGTTGTATAT
GAGGTTATACAGCAGTTCT -> AGGTTATACAGCAGTTCTA
GAGTAATCACTTCGAACAC -> AGTAATCACTTCGAACACG
GAGTACAGCGCGTTTAGGG -> AGTACAGCGCGTTTAGGGC
GAGTATATTTAAATCCTAT -> AGTATATTTAAATCCTATC
GAGTCGGCCCGAGCAACTC -> AGTCGGCCCGAGCAACTCC
GAGTGAACGTTAGTGCGAA -> AGTGAACGTTAGTGCGAAA
GAGTGACTAGAAGTCAACG -> AGTGACTAGAAGTCAACGT
GAGTGAGCCCCCGCGCAGC -> AGTGAGCCCCCGCGCAGCA
GAGTGATGAGTGACTAGAA -> AGTGATGAGTGACTAGAAG
GAGTGTACACCCCGGTAAC -> AGTGTACACCCCGGTAACA
GAGTGTCTCTGTAAGCCGG -> AGTGTCTCTGTAAGCCGGT
GAGTTATGTTACGCGCCTT -> AGTTATGTTACGCGCCTTT
GATAACCCAGGTGTGACTA -> ATAACCCAGGTGTGACTAC
GATAACCGGGGCGAGGGTC -> ATAACCGGGGCGAGGGTCG
GATAACGTTTATCCAGCTC -> ATAACGTTTATCCAGCTCG
GATAATACATAAAACACAG -> ATAATACATAAAACACAGT
GATACGACAATTCGTCTTG -> ATACGACAATTCGTCTTGA
GATAGGATAACGTTTATCC -> ATAGGATAACGTTTATCCA
GATATGTTAGGGCAGTCAA -> ATATGTTAGGGCAGTCAAT
GATATTTTTAACTGACCGG -> ATATTTTTAACTGACCGGT
GATCATCTGACAGCGCTCG -> ATCATCTGACAGCGCTCGA
GATCATCTGGGGTGATAAC -> ATCATCTGGGGTGATAACC
GATCCCGCAGTTCAATACG -> ATCCCGCAGTTCAATACGG
GATCCGAGCCCTACTGTCG -> ATCCGAGCCCTACTGTCGC
GATCCTCAACTGTTCTCAA -> ATCCTCAACTGTTCTCAAA
GATCGTTGCGCACAACTTC -> ATCGTTGCGCACAACTTCC
GATCTCACAGTTCTTATCG -> ATCTCACAGTTCTTATCGT
GATCTGCGTCCTACTGACT -> ATCTGCGTCCTACTGACTG
GATCTGGTAACATGCCCAC -> ATCTGGTAACATGCCCACC
GATGAGTGACTAGAAGTCA -> ATGAGTGACTAGAAGTCAA
GATGATAACCCAGGTGTGA -> ATGATAACCCAGGTGTGAC
GATGATGGGTCATCTGCGT -> ATGATGGGTCATCTGCGTA
GATGCATTTCTATGTGTTT -> ATGCATTTCTATGTGTTTA
GATGCCTTCTGCTGGCTTA -> ATGCCTTCTGCTGGCTTAC
GATGGATCCCGCAGTTCAA -> ATGGATCCCGCAGTTCAAT
GATGGATGATAACCCAGGT -> ATGGATGATAACCCAGGTG
GATGGGTCATCTGCGTAGC -> ATGGGTCATCTGCGTAGCT
GATGGGTGAGCTCACAAAT -> ATGGGTGAGCTCACAAATC
GATGTAATATCGAGTCGGC -> ATGTAATATCGAGTCGGCC
GATGTTGGATAGGATAACG -> ATGTTGGATAGGATAACGT
GATTGCAGTTTAAAACTAG -> ATTGCAGTTTAAAACTAGT
GATTGCGCTCACATGGTAG -> ATTGCGCTCACATGGTAGC
GATTGCGGTGGAATGAGGT -> ATTGCGGTGGAATGAGGTG
GATTGGCTGTATAGGCCAG -> ATTGGCTGTATAGGCCAGC
GATTTGGGAGAGCCGAGTG -> ATTTGGGAGAGCCGAGTGT
GCAACAAGATCTGGTAACA -> CAACAAGATCTGGTAACAT
GCAACTCCTTCCGAACGGT -> CAACTCCTTCCGAACGGTG
GCAATAACGAGACACTCTA -> CAATAACGAGACACTCTAC
GCACAACTTCCGGACTAAA -> CACAACTTCCGGACTAAAT
GCACGCCATTTAAATACGT -> CACGCCATTTAAATACGTT
GCACGTGGAGAACGGGTTC -> CACGTGGAGAACGGGTTCC
GCACTCAGACCAGCGTAGG -> CACTCAGACCAGCGTAGGT
GCAGATTGGCTGTATAGGC -> CAGATTGGCTGTATAGGCC
GCAGCACTCAGACCAGCGT -> CAGCACTCAGACCAGCGTA
GCAGCCCTTACACCGGCGA -> CAGCCCTTACACCGGCGAT
GCAGGACTTTTTGACAGCA -> CAGGACTTTTTGACAGCAT
GCAGGCCCTCAACGTGTCG -> CAGGCCCTCAACGTGTCGC
GCAGTCAATGTGGTTTTTC -> CAGTCAATGTGGTTTTTCC
GCAGTGAACACGGCATCTA -> CAGTGAACACGGCATCTAT
GCAGTGTCATAGTTATTTG -> CAGTGTCATAGTTATTTGT
GCAGTTCAATACGGGCGTC -> CAGTTCAATACGGGCGTCG
GCAGTTCTACTAATTCTCG -> CAGTTCTACTAATTCTCGA
GCAGTTTAAAACTAGTCTC -> CAGTTTAAAACTAGTCTCA
GCATCTATGGTACAGGTCC -> CATCTATGGTACAGGTCCA
GCATTTCTATGTGTTTAGC -> CATTTCTATGTGTTTAGCG
GCATTTGTTGCAGATTGGC -> CATTTGTTGCAGATTGGCT
GCATTTGTTGCCAGGGCTG -> CATTTGTTGCCAGGGCTGT
GCATTTGTTGGCGGCGTCA -> CATTTGTTGGCGGCGTCAT
GCATTTGTTGGCTAGGGTG -> CATTTGTTGGCTAGGGTGC
GCCAAACTAAACTATTACA -> CCAAACTAAACTATTACAA
GCCACGGTCGAGAGCGTTT -> CCACGGTCGAGAGCGTTTA
GCCACTGGTGTCTACTTTA -> CCACTGGTGTCTACTTTAT
GCCAGAGACGAGTAATCAC -> CCAGAGACGAGTAATCACT
GCCAGCCGTCTTAGGGCGA -> CCAGCCGTCTTAGGGCGAC
GCCAGCTGAGGTTATACAG -> CCAGCTGAGGTTATACAGC
GCCAGGCTCCCGTGGCAAT -> CCAGGCTCCCGTGGCAATA
GCCAGGGCTGTTACGTTTA -> CCAGGGCTGTTACGTTTAC
GCCATTTAAATACGTTATG -> CCATTTAAATACGTTATGG
GCCCACCATCAAGTTCGTA -> CCCACCATCAAGTTCGTAA
GCCCCAAGGGGGACCTAAG -> CCCCAAGGGGGACCTAAGG
GCCCCACAAAACAGACATC -> CCCCACAAAACAGACATCT
GCCCCCGCGCAGCACTCAG -> CCCCCGCGCAGCACTCAGA
GCCCGAGCAACTCCTTCCG -> CCCGAGCAACTCCTTCCGA
GCCCTACTGTCGCGCTTGT -> CCCTACTGTCGCGCTTGTC
GCCCTCAACGTGTCGCGCT -> CCCTCAACGTGTCGCGCTT
GCCCTGCTTCACCATCGCC -> CCCTGCTTCACCATCGCCA
GCCCTTACACCGGCGATGG -> CCCTTACACCGGCGATGGG
GCCGAAGCCCTGCTTCACC -> CCGAAGCCCTGCTTCACCA
GCCGAGTGTCTCTGTAAGC -> CCGAGTGTCTCTGTAAGCC
GCCGATTGCGGTGGAATGA -> CCGATTGCGGTGGAATGAG
GCCGGATGGATCCCGCAGT -> CCGGATGGATCCCGCAGTT
GCCGGTATCTAAGTCGGCT -> CCGGTATCTAAGTCGGCTG
GCCGGTTCGTGTCGCGGTA -> CCGGTTCGTGTCGCGGTAC
GCCGTCATTTTTGACAGCA -> CCGTCATTTTTGACAGCAT
GCCGTCCGTCGGCTGGAGG -> CCGTCCGTCGGCTGGAGGT
GCCGTCTTAGGGCGACAGC -> CCGTCTTAGGGCGACAGCA
GCCTAGGAGAACGCTAGTG -> CCTAGGAGAACGCTAGTGT
GCCTATAAGTCATATGATC -> CCTATAAGTCATATGATCA
GCCTCGGGACTAGCCGGTA -> CCTCGGGACTAGCCGGTAT
GCCTTCTGCTGGCTTACGT -> CCTTCTGCTGGCTTACGTG
GCCTTTATCCAGACTCTGA -> CCTTTATCCAGACTCTGAG
GCCTTTGTCGTTATTAGGG -> CCTTTGTCGTTATTAGGGG
GCGAAAATAACCTCTGACC -> CGAAAATAACCTCTGACCC
GCGAAATAACAATGCAGGC -> CGAAATAACAATGCAGGCC
GCGACAGCAGTGTCATAGT -> CGACAGCAGTGTCATAGTT
GCGACTTTGCCGTCCGTCG -> CGACTTTGCCGTCCGTCGG
GCGAGGGTCGGTGTGTTAG -> CGAGGGTCGGTGTGTTAGA
GCGATGGGTGAGCTCACAA -> CGATGGGTGAGCTCACAAA
GCGCACAACTTCCGGACTA -> CGCACAACTTCCGGACTAA
GCGCAGCACTCAGACCAGC -> CGCAGCACTCAGACCAGCG
GCGCCTTTATCCAGACTCT -> CGCCTTTATCCAGACTCTG
GCGCGTTTAGGGCCAAACT -> CGCGTTTAGGGCCAAACTA
GCGCTCACATGGTAGCCCC -> CGCTCACATGGTAGCCCCA
GCGCTCGATCCGAGCCCTA -> CGCTCGATCCGAGCCCTAC
GCGCTTGTCCAAACAGCTG -> CGCTTGTCCAAACAGCTGC
GCGCTTGTCCAAACCTACG -> CGCTTGTCCAAACCTACGC
GCGCTTGTCCAAACGAGGT -> CGCTTGTCCAAACGAGGTC
GCGCTTGTCCAAACTACTT -> CGCTTGTCCAAACTACTTT
GCGGAGAAACCGCGAAATA -> CGGAGAAACCGCGAAATAA
GCGGCGTCATATAATAAGA -> CGGCGTCATATAATAAGAC
GCGGGCACGTGGAGAACGG -> CGGGCACGTGGAGAACGGG
GCGGTACTCCGAACATTAA -> CGGTACTCCGAACATTAAA
GCGGTGCCAGGCTCCCGTG -> CGGTGCCAGGCTCCCGTGG
GCGGTGGAATGAGGTGTTC -> CGGTGGAATGAGGTGTTCC
GCGTAGCTTCGGTCTTGTT -> CGTAGCTTCGGTCTTGTTC
GCGTAGGTGTGATGGATGA -> CGTAGGTGTGATGGATGAT
GCGTCATATAATAAGACCA -> CGTCATATAATAAGACCAC
GCGTCCTACTGACTGACTC -> CGTCCTACTGACTGACTCG
GCGTCGACGAAATCGGGAC -> CGTCGACGAAATCGGGACA
GCGTGACGTCGGGACGCCG -> CGTGACGTCGGGACGCCGA
GCGTTCGGGCAACAAGATC -> CGTTCGGGCAACAAGATCT
GCGTTGAGACTTCAAGGTT -> CGTTGAGACTTCAAGGTTC
GCGTTTAGGGCCAAACTAA -> CGTTTAGGGCCAAACTAAA
GCGTTTATCCATGGGGGAC -> CGTTTATCCATGGGGGACA
GCTAGGGTGCGGAGAAACC -> CTAGGGTGCGGAGAAACCG
GCTAGTGTATTTGTCGCGC -> CTAGTGTATTTGTCGCGCT
GCTCACAAATCACTCGAGA -> CTCACAAATCACTCGAGAG
GCTCACATGGTAGCCCCAC -> CTCACATGGTAGCCCCACA
GCTCAGTCCTAGAGGAACA -> CTCAGTCCTAGAGGAACAA
GCTCAGTGTGAAGAGTGAA -> CTCAGTGTGAAGAGTGAAC
GCTCCCGTGGCAATAACGA -> CTCCCGTGGCAATAACGAG
GCTCCTTTCAGCGGGCACG -> CTCCTTTCAGCGGGCACGT
GCTCGAGCCCCAAGGGGGA -> CTCGAGCCCCAAGGGGGAC
GCTCGATCCGAGCCCTACT -> CTCGATCCGAGCCCTACTG
GCTCTCAATGTCGCGCTTG -> CTCTCAATGTCGCGCTTGT
GCTCTCCCGTGTACTTTGA -> CTCTCCCGTGTACTTTGAT
GCTGAGGTTATACAGCAGT -> CTGAGGTTATACAGCAGTT
GCTGATCCTCAACTGTTCT -> CTGATCCTCAACTGTTCTC
GCTGCCGTCATTTTTGACA -> CTGCCGTCATTTTTGACAG
GCTGGAGGTACGGTGTAAA -> CTGGAGGTACGGTGTAAAT
GCTGGCTCTCAATGTCGCG -> CTGGCTCTCAATGTCGCGC
GCTGGCTTACGTGGTAGAA -> CTGGCTTACGTGGTAGAAT
GCTGTATAGGCCAGCTGAG -> CTGTATAGGCCAGCTGAGG
GCTGTTACGTTTACGTTAA -> CTGTTACGTTTACGTTAAG
GCTTACGTGGTAGAATAAC -> CTTACGTGGTAGAATAACC
GCTTCACCATCGCCACGGT -> CTTCACCATCGCCACGGTC
GCTTCGGTCTTGTTCGCGT -> CTTCGGTCTTGTTCGCGTG
GCTTGGATGTAATATCGAG -> CTTGGATGTAATATCGAGT
GCTTGGTATTTTGAACTGG -> CTTGGTATTTTGAACTGGG
GCTTGTCCAAACAGCTGCC -> CTTGTCCAAACAGCTGCCG
GCTTGTCCAAACCTACGCA -> CTTGTCCAAACCTACGCAG
GCTTGTCCAAACGAGGTCT -> CTTGTCCAAACGAGGTCTA
GCTTGTCCAAACTACTTTC -> CTTGTCCAAACTACTTTCC
GGAACAATAGTACCGACCT -> GAACAATAGTACCGACCTG
GGAATGAGGTGTTCCCGTT -> GAATGAGGTGTTCCCGTTG
GGACACACGAACTCTCGCC -> GACACACGAACTCTCGCCA
GGACATAGACTGTTATGAA -> GACATAGACTGTTATGAAC
GGACCTAAGGTAATAGCCT -> GACCTAAGGTAATAGCCTC
GGACGCCGATTGCGGTGGA -> GACGCCGATTGCGGTGGAA
GGACTAAATTCCCAGAAGG -> GACTAAATTCCCAGAAGGG
GGACTAAGTGAGTTATGTT -> GACTAAGTGAGTTATGTTA
GGACTAGCCGGTATCTAAG -> GACTAGCCGGTATCTAAGT
GGACTTTTTGACAGCATTT -> GACTTTTTGACAGCATTTG
GGAGAAACCGCGAAATAAC -> GAGAAACCGCGAAATAACA
GGAGAACGCTAGTGTATTT -> GAGAACGCTAGTGTATTTG
GGAGAACGGGTTCCTATGA -> GAGAACGGGTTCCTATGAT
GGAGAAGCTTGGATGTAAT -> GAGAAGCTTGGATGTAATA
GGAGAGCCGAGTGTCTCTG -> GAGAGCCGAGTGTCTCTGT
GGAGCCTTTGTCGTTATTA -> GAGCCTTTGTCGTTATTAG
GGAGGCCTATAAGTCATAT -> GAGGCCTATAAGTCATATG
GGAGGTACGGTGTAAATCA -> GAGGTACGGTGTAAATCAC
GGAGGTATATCAAAGCTCT -> GAGGTATATCAAAGCTCTC
GGAGTGAGCCCCCGCGCAG -> GAGTGAGCCCCCGCGCAGC
GGAGTGTACACCCCGGTAA -> GAGTGTACACCCCGGTAAC
GGATAACGTTTATCCAGCT -> GATAACGTTTATCCAGCTC
GGATAGGATAACGTTTATC -> GATAGGATAACGTTTATCC
GGATCATCTGGGGTGATAA -> GATCATCTGGGGTGATAAC
GGATCCCGCAGTTCAATAC -> GATCCCGCAGTTCAATACG
GGATCGTTGCGCACAACTT -> GATCGTTGCGCACAACTTC
GGATGATAACCCAGGTGTG -> GATGATAACCCAGGTGTGA
GGATGCATTTCTATGTGTT -> GATGCATTTCTATGTGTTT
GGATGCCTTCTGCTGGCTT -> GATGCCTTCTGCTGGCTTA
GGATGGATCCCGCAGTTCA -> GATGGATCCCGCAGTTCAA
GGATGTAATATCGAGTCGG -> GATGTAATATCGAGTCGGC
GGATGTTGGATAGGATAAC -> GATGTTGGATAGGATAACG
GGCAACAAGATCTGGTAAC -> GCAACAAGATCTGGTAACA
GGCAATAACGAGACACTCT -> GCAATAACGAGACACTCTA
GGCACGCCATTTAAATACG -> GCACGCCATTTAAATACGT
GGCACGTGGAGAACGGGTT -> GCACGTGGAGAACGGGTTC
GGCAGTCAATGTGGTTTTT -> GCAGTCAATGTGGTTTTTC
GGCATCTATGGTACAGGTC -> GCATCTATGGTACAGGTCC
GGCCAAACTAAACTATTAC -> GCCAAACTAAACTATTACA
GGCCAGCCGTCTTAGGGCG -> GCCAGCCGTCTTAGGGCGA
GGCCAGCTGAGGTTATACA -> GCCAGCTGAGGTTATACAG
GGCCCGAGCAACTCCTTCC -> GCCCGAGCAACTCCTTCCG
GGCCCTCAACGTGTCGCGC -> GCCCTCAACGTGTCGCGCT
GGCCGAAGCCCTGCTTCAC -> GCCGAAGCCCTGCTTCACC
GGCCTAGGAGAACGCTAGT -> GCCTAGGAGAACGCTAGTG
GGCCTATAAGTCATATGAT -> GCCTATAAGTCATATGATC
GGCGACAGCAGTGTCATAG -> GCGACAGCAGTGTCATAGT
GGCGAGGGTCGGTGTGTTA -> GCGAGGGTCGGTGTGTTAG
GGCGATGGGTGAGCTCACA -> GCGATGGGTGAGCTCACAA
GGCGGCGTCATATAATAAG -> GCGGCGTCATATAATAAGA
GGCGTCATATAATAAGACC -> GCGTCATATAATAAGACCA
GGCGTCGACGAAATCGGGA -> GCGTCGACGAAATCGGGAC
GGCGTTCGGGCAACAAGAT -> GCGTTCGGGCAACAAGATC
GGCTAGGGTGCGGAGAAAC -> GCTAGGGTGCGGAGAAACC
GGCTCCCGTGGCAATAACG -> GCTCCCGTGGCAATAACGA
GGCTCTCAATGTCGCGCTT -> GCTCTCAATGTCGCGCTTG
GGCTGATCCTCAACTGTTC -> GCTGATCCTCAACTGTTCT
GGCTGGAGGTACGGTGTAA -> GCTGGAGGTACGGTGTAAA
GGCTGGCTCTCAATGTCGC -> GCTGGCTCTCAATGTCGCG
GGCTGTATAGGCCAGCTGA -> GCTGTATAGGCCAGCTGAG
GGCTGTTACGTTTACGTTA -> GCTGTTACGTTTACGTTAA
GGCTTACGTGGTAGAATAA -> GCTTACGTGGTAGAATAAC
GGGACACACGAACTCTCGC -> GGACACACGAACTCTCGCC
GGGACATAGACTGTTATGA -> GGACATAGACTGTTATGAA
GGGACCTAAGGTAATAGCC -> GGACCTAAGGTAATAGCCT
GGGACGCCGATTGCGGTGG -> GGACGCCGATTGCGGTGGA
GGGACTAGCCGGTATCTAA -> GGACTAGCCGGTATCTAAG
GGGAGAGCCGAGTGTCTCT -> GGAGAGCCGAGTGTCTCTG
GGGAGTGAGCCCCCGCGCA -> GGAGTGAGCCCCCGCGCAG
GGGATGCCTTCTGCTGGCT -> GGATGCCTTCTGCTGGCTT
GGGCAACAAGATCTGGTAA -> GGCAACAAGATCTGGTAAC
GGGCACGTGGAGAACGGGT -> GGCACGTGGAGAACGGGTT
GGGCAGTCAATGTGGTTTT -> GGCAGTCAATGTGGTTTTT
GGGCCAAACTAAACTATTA -> GGCCAAACTAAACTATTAC
GGGCGACAGCAGTGTCATA -> GGCGACAGCAGTGTCATAG
GGGCGAGGGTCGGTGTGTT -> GGCGAGGGTCGGTGTGTTA
GGGCGTCGACGAAATCGGG -> GGCGTCGACGAAATCGGGA
GGGCGTTCGGGCAACAAGA -> GGCGTTCGGGCAACAAGAT
GGGCTGTTACGTTTACGTT -> GGCTGTTACGTTTACGTTA
GGGGACATAGACTGTTATG -> GGGACATAGACTGTTATGA
GGGGACCTAAGGTAATAGC -> GGGACCTAAGGTAATAGCC
GGGGCGAGGGTCGGTGTGT -> GGGCGAGGGTCGGTGTGTT
GGGGGACATAGACTGTTAT -> GGGGACATAGACTGTTATG
GGGGGACCTAAGGTAATAG -> GGGGACCTAAGGTAATAGC
GGGGGTTGATTTGGGAGAG -> GGGGTTGATTTGGGAGAGC
GGGGTGAGTATATTTAAAT -> GGGTGAGTATATTTAAATC
GGGGTGATAACCGGGGCGA -> GGGTGATAACCGGGGCGAG
GGGGTTGATTTGGGAGAGC -> GGGTTGATTTGGGAGAGCC
GGGTCATCTGCGTAGCTTC -> GGTCATCTGCGTAGCTTCG
GGGTCGACCCGGCTAGAAG -> GGTCGACCCGGCTAGAAGT
GGGTCGGTGTGTTAGATCT -> GGTCGGTGTGTTAGATCTC
GGGTGAGCTCACAAATCAC -> GGTGAGCTCACAAATCACT
GGGTGAGTATATTTAAATC -> GGTGAGTATATTTAAATCC
GGGTGATAACCGGGGCGAG -> GGTGATAACCGGGGCGAGG
GGGTGATATTTTTAACTGA -> GGTGATATTTTTAACTGAC
GGGTGCGGAGAAACCGCGA -> GGTGCGGAGAAACCGCGAA
GGGTTCCTATGATGATGGG -> GGTTCCTATGATGATGGGT
GGGTTGATTTGGGAGAGCC -> GGTTGATTTGGGAGAGCCG
GGTAAAGAGGCCAGCCGTC -> GTAAAGAGGCCAGCCGTCT
GGTAACACCACCGGAGGTA -> GTAACACCACCGGAGGTAT
GGTAACATGCCCACCATCA -> GTAACATGCCCACCATCAA
GGTAATAGCCTCGGGACTA -> GTAATAGCCTCGGGACTAG
GGTACAGGTCCAAGATACG -> GTACAGGTCCAAGATACGA
GGTACGGGCGTTCGGGCAA -> GTACGGGCGTTCGGGCAAC
GGTACGGTGTAAATCACAG -> GTACGGTGTAAATCACAGC
GGTACTCCGAACATTAAAA -> GTACTCCGAACATTAAAAC
GGTAGAATAACCATCGCGA -> GTAGAATAACCATCGCGAC
GGTAGCCCCACAAAACAGA -> GTAGCCCCACAAAACAGAC
GGTATATCAAAGCTCTCCC -> GTATATCAAAGCTCTCCCG
GGTATCTAAGTCGGCTGAT -> GTATCTAAGTCGGCTGATC
GGTATTTTGAACTGGGTCG -> GTATTTTGAACTGGGTCGA
GGTCATCTGCGTAGCTTCG -> GTCATCTGCGTAGCTTCGG
GGTCCAAGATACGACAATT -> GTCCAAGATACGACAATTC
GGTCCTAGGAGCCTTTGTC -> GTCCTAGGAGCCTTTGTCG
GGTCGACCCGGCTAGAAGT -> GTCGACCCGGCTAGAAGTG
GGTCGAGAGCGTTTATCCA -> GTCGAGAGCGTTTATCCAT
GGTCGGTGTGTTAGATCTC -> GTCGGTGTGTTAGATCTCA
GGTCTAACCTTTTTGACAG -> GTCTAACCTTTTTGACAGC
GGTCTTGTTCGCGTGACGT -> GTCTTGTTCGCGTGACGTC
GGTGAGCTCACAAATCACT -> GTGAGCTCACAAATCACTC
GGTGAGTATATTTAAATCC -> GTGAGTATATTTAAATCCT
GGTGATAACCGGGGCGAGG -> GTGATAACCGGGGCGAGGG
GGTGATATTTTTAACTGAC -> GTGATATTTTTAACTGACC
GGTGCAGCCCTTACACCGG -> GTGCAGCCCTTACACCGGC
GGTGCCAGGCTCCCGTGGC -> GTGCCAGGCTCCCGTGGCA
GGTGCGGAGAAACCGCGAA -> GTGCGGAGAAACCGCGAAA
GGTGGAATGAGGTGTTCCC -> GTGGAATGAGGTGTTCCCG
GGTGGATCGTTGCGCACAA -> GTGGATCGTTGCGCACAAC
GGTGTAAATCACAGCTTGG -> GTGTAAATCACAGCTTGGT
GGTGTACCCTGGAGTGTAC -> GTGTACCCTGGAGTGTACA
GGTGTCTACTTTATGAGTG -> GTGTCTACTTTATGAGTGA
GGTGTCTTCGCAGTGAACA -> GTGTCTTCGCAGTGAACAC
GGTGTGACTACTAGATTGC -> GTGTGACTACTAGATTGCG
GGTGTGATGGATGATAACC -> GTGTGATGGATGATAACCC
GGTGTGTTAGATCTCACAG -> GTGTGTTAGATCTCACAGT
GGTGTTCCCGTTGTATATG -> GTGTTCCCGTTGTATATGG
GGTTATACAGCAGTTCTAC -> GTTATACAGCAGTTCTACT
GGTTCCTATGATGATGGGT -> GTTCCTATGATGATGGGTC
GGTTCGGTACGGGCGTTCG -> GTTCGGTACGGGCGTTCGG
GGTTCGTGTCGCGGTACTC -> GTTCGTGTCGCGGTACTCC
GGTTGATTTGGGAGAGCCG -> GTTGATTTGGGAGAGCCGA
GGTTTTTCCCGGGATGCCT -> GTTTTTCCCGGGATGCCTT
GTAAAGAGGCCAGCCGTCT -> TAAAGAGGCCAGCCGTCTT
GTAAATCACAGCTTGGTAT -> TAAATCACAGCTTGGTATT
GTAACACCACCGGAGGTAT -> TAACACCACCGGAGGTATA
GTAACATGCCCACCATCAA -> TAACATGCCCACCATCAAG
GTAAGCCGGTTCGTGTCGC -> TAAGCCGGTTCGTGTCGCG
GTAAGTCTTGAGGATGTTG -> TAAGTCTTGAGGATGTTGG
GTAATAGCCTCGGGACTAG -> TAATAGCCTCGGGACTAGC
GTAATATCGAGTCGGCCCG -> TAATATCGAGTCGGCCCGA
GTAATCACTTCGAACACGG -> TAATCACTTCGAACACGGT
GTACACCCCGGTAACACCA -> TACACCCCGGTAACACCAC
GTACAGCGCGTTTAGGGCC -> TACAGCGCGTTTAGGGCCA
GTACAGGTCCAAGATACGA -> TACAGGTCCAAGATACGAC
GTACCCATTAGTGCCAGAG -> TACCCATTAGTGCCAGAGA
GTACCCGCTCCTTTCAGCG -> TACCCGCTCCTTTCAGCGG
GTACCCTGGAGTGTACACC -> TACCCTGGAGTGTACACCC
GTACCGACCTGGTAAAGAG -> TACCGACCTGGTAAAGAGG
GTACCTCTAATGGCTGGCT -> TACCTCTAATGGCTGGCTC
GTACGGGCGTTCGGGCAAC -> TACGGGCGTTCGGGCAACA
GTACGGTGTAAATCACAGC -> TACGGTGTAAATCACAGCT
GTACTCCGAACATTAAAAC -> TACTCCGAACATTAAAACG
GTACTTTGATTGCAGTTTA -> TACTTTGATTGCAGTTTAA
GTAGAATAACCATCGCGAC -> TAGAATAACCATCGCGACT
GTAGCCCCACAAAACAGAC -> TAGCCCCACAAAACAGACA
GTAGCTTCGGTCTTGTTCG -> TAGCTTCGGTCTTGTTCGC
GTAGGTGTGATGGATGATA -> TAGGTGTGATGGATGATAA
GTATAGGCCAGCTGAGGTT -> TATAGGCCAGCTGAGGTTA
GTATATCAAAGCTCTCCCG -> TATATCAAAGCTCTCCCGT
GTATATGGATGCATTTCTA -> TATATGGATGCATTTCTAT
GTATATTTAAATCCTATCG -> TATATTTAAATCCTATCGG
GTATCGACTTAACATTTCC -> TATCGACTTAACATTTCCT
GTATCTAAGTCGGCTGATC -> TATCTAAGTCGGCTGATCC
GTATTTGTCGCGCTTGTCC -> TATTTGTCGCGCTTGTCCA
GTATTTTGAACTGGGTCGA -> TATTTTGAACTGGGTCGAC
GTCAACGTGGACTAAGTGA -> TCAACGTGGACTAAGTGAG
GTCAATGTGGTTTTTCCCG -> TCAATGTGGTTTTTCCCGG
GTCACTATCCCCGGAGGCC -> TCACTATCCCCGGAGGCCT
GTCAGGGTGATATTTTTAA -> TCAGGGTGATATTTTTAAC
GTCATAGTTATTTGTCCGT -> TCATAGTTATTTGTCCGTA
GTCATATAATAAGACCACA -> TCATATAATAAGACCACAA
GTCATATGATCATCTGACA -> TCATATGATCATCTGACAG
GTCATCTGCGTAGCTTCGG -> TCATCTGCGTAGCTTCGGT
GTCATTTTTGACAGCATTT -> TCATTTTTGACAGCATTTG
GTCCAAACAGCTGCCGTCA -> TCCAAACAGCTGCCGTCAT
GTCCAAACCTACGCAGGAC -> TCCAAACCTACGCAGGACT
GTCCAAACGAGGTCTAACC -> TCCAAACGAGGTCTAACCT
GTCCAAACTACTTTCCACT -> TCCAAACTACTTTCCACTT
GTCCAAGATACGACAATTC -> TCCAAGATACGACAATTCG
GTCCGTACCCGCTCCTTTC -> TCCGTACCCGCTCCTTTCA
GTCCGTCGGCTGGAGGTAC -> TCCGTCGGCTGGAGGTACG
GTCCTACTGACTGACTCGC -> TCCTACTGACTGACTCGCT
GTCCTAGAGGAACAATAGT -> TCCTAGAGGAACAATAGTA
GTCCTAGGAGCCTTTGTCG -> TCCTAGGAGCCTTTGTCGT
GTCGAAGGGGTGAGTATAT -> TCGAAGGGGTGAGTATATT
GTCGACCCGGCTAGAAGTG -> TCGACCCGGCTAGAAGTGT
GTCGACGAAATCGGGACAC -> TCGACGAAATCGGGACACA
GTCGAGAGCGTTTATCCAT -> TCGAGAGCGTTTATCCATG
GTCGCGCTTGTCCAAACAG -> TCGCGCTTGTCCAAACAGC
GTCGCGCTTGTCCAAACCT -> TCGCGCTTGTCCAAACCTA
GTCGCGCTTGTCCAAACGA -> TCGCGCTTGTCCAAACGAG
GTCGCGCTTGTCCAAACTA -> TCGCGCTTGTCCAAACTAC
GTCGCGGTACTCCGAACAT -> TCGCGGTACTCCGAACATT
GTCGGCCCGAGCAACTCCT -> TCGGCCCGAGCAACTCCTT
GTCGGCTGATCCTCAACTG -> TCGGCTGATCCTCAACTGT
GTCGGCTGGAGGTACGGTG -> TCGGCTGGAGGTACGGTGT
GTCGGGACGCCGATTGCGG -> TCGGGACGCCGATTGCGGT
GTCGGTGTGTTAGATCTCA -> TCGGTGTGTTAGATCTCAC
GTCGTTATTAGGGGGTTGA -> TCGTTATTAGGGGGTTGAT
GTCTAACCTTTTTGACAGC -> TCTAACCTTTTTGACAGCA
GTCTACTTTATGAGTGATG -> TCTACTTTATGAGTGATGA
GTCTCATTGTACCCATTAG -> TCTCATTGTACCCATTAGT
GTCTCTGTAAGCCGGTTCG -> TCTCTGTAAGCCGGTTCGT
GTCTTAGGGCGACAGCAGT -> TCTTAGGGCGACAGCAGTG
GTCTTCGCAGTGAACACGG -> TCTTCGCAGTGAACACGGC
GTCTTGAGGATGTTGGATA -> TCTTGAGGATGTTGGATAG
GTCTTGATCTGCGTCCTAC -> TCTTGATCTGCGTCCTACT
GTCTTGTTCGCGTGACGTC -> TCTTGTTCGCGTGACGTCG
GTGAACACGGCATCTATGG -> TGAACACGGCATCTATGGT
GTGAACGTTAGTGCGAAAA -> TGAACGTTAGTGCGAAAAT
GTGAAGAGTGAACGTTAGT -> TGAAGAGTGAACGTTAGTG
GTGACGTCGGGACGCCGAT -> TGACGTCGGGACGCCGATT
GTGACTACTAGATTGCGCT -> TGACTACTAGATTGCGCTC
GTGACTAGAAGTCAACGTG -> TGACTAGAAGTCAACGTGG
GTGAGCCCCCGCGCAGCAC -> TGAGCCCCCGCGCAGCACT
GTGAGCTCACAAATCACTC -> TGAGCTCACAAATCACTCG
GTGAGTATATTTAAATCCT -> TGAGTATATTTAAATCCTA
GTGAGTTATGTTACGCGCC -> TGAGTTATGTTACGCGCCT
GTGATAACCGGGGCGAGGG -> TGATAACCGGGGCGAGGGT
GTGATATTTTTAACTGACC -> TGATATTTTTAACTGACCG
GTGATGAGTGACTAGAAGT -> TGATGAGTGACTAGAAGTC
GTGATGGATGATAACCCAG -> TGATGGATGATAACCCAGG
GTGCAGCCCTTACACCGGC -> TGCAGCCCTTACACCGGCG
GTGCCAGAGACGAGTAATC -> TGCCAGAGACGAGTAATCA
GTGCCAGGCTCCCGTGGCA -> TGCCAGGCTCCCGTGGCAA
GTGCGAAAATAACCTCTGA -> TGCGAAAATAACCTCTGAC
GTGCGGAGAAACCGCGAAA -> TGCGGAGAAACCGCGAAAT
GTGGAATGAGGTGTTCCCG -> TGGAATGAGGTGTTCCCGT
GTGGACTAAGTGAGTTATG -> TGGACTAAGTGAGTTATGT
GTGGAGAACGGGTTCCTAT -> TGGAGAACGGGTTCCTATG
GTGGATCATCTGGGGTGAT -> TGGATCATCTGGGGTGATA
GTGGATCGTTGCGCACAAC -> TGGATCGTTGCGCACAACT
GTGGCAATAACGAGACACT -> TGGCAATAACGAGACACTC
GTGGTAGAATAACCATCGC -> TGGTAGAATAACCATCGCG
GTGGTTTTTCCCGGGATGC -> TGGTTTTTCCCGGGATGCC
GTGTAAATCACAGCTTGGT -> TGTAAATCACAGCTTGGTA
GTGTACACCCCGGTAACAC -> TGTACACCCCGGTAACACC
GTGTACCCTGGAGTGTACA -> TGTACCCTGGAGTGTACAC
GTGTACTTTGATTGCAGTT -> TGTACTTTGATTGCAGTTT
GTGTATTTGTCGCGCTTGT -> TGTATTTGTCGCGCTTGTC
GTGTCACTATCCCCGGAGG -> TGTCACTATCCCCGGAGGC
GTGTCATAGTTATTTGTCC -> TGTCATAGTTATTTGTCCG
GTGTCGCGCTTGTCCAAAC -> TGTCGCGCTTGTCCAAACG
GTGTCGCGGTACTCCGAAC -> TGTCGCGGTACTCCGAACA
GTGTCTACTTTATGAGTGA -> TGTCTACTTTATGAGTGAT
GTGTCTCTGTAAGCCGGTT -> TGTCTCTGTAAGCCGGTTC
GTGTCTTCGCAGTGAACAC -> TGTCTTCGCAGTGAACACG
GTGTGAAGAGTGAACGTTA -> TGTGAAGAGTGAACGTTAG
GTGTGACTACTAGATTGCG -> TGTGACTACTAGATTGCGC
GTGTGATGGATGATAACCC -> TGTGATGGATGATAACCCA
GTGTGTTAGATCTCACAGT -> TGTGTTAGATCTCACAGTT
GTGTTAGATCTCACAGTTC -> TGTTAGATCTCACAGTTCT
GTGTTCCCGTTGTATATGG -> TGTTCCCGTTGTATATGGA
GTGTTTAGCGGTGCCAGGC -> TGTTTAGCGGTGCCAGGCT
GTTAAGCGTTGAGACTTCA -> TTAAGCGTTGAGACTTCAA
GTTAATATATTCTAGTCAG -> TTAATATATTCTAGTCAGG
GTTACGCGCCTTTATCCAG -> TTACGCGCCTTTATCCAGA
GTTACGTTTACGTTAAGCG -> TTACGTTTACGTTAAGCGT
GTTAGATCTCACAGTTCTT -> TTAGATCTCACAGTTCTTA
GTTAGGGCAGTCAATGTGG -> TTAGGGCAGTCAATGTGGT
GTTAGTGCGAAAATAACCT -> TTAGTGCGAAAATAACCTC
GTTATACAGCAGTTCTACT -> TTATACAGCAGTTCTACTA
GTTATGAACACTTCCGAAT -> TTATGAACACTTCCGAATC
GTTATGGCCTAGGAGAACG -> TTATGGCCTAGGAGAACGC
GTTATGTTACGCGCCTTTA -> TTATGTTACGCGCCTTTAT
GTTATTAGGGGGTTGATTT -> TTATTAGGGGGTTGATTTG
GTTATTTGTCCGTACCCGC -> TTATTTGTCCGTACCCGCT
GTTCAATACGGGCGTCGAC -> TTCAATACGGGCGTCGACG
GTTCCCGTTGTATATGGAT -> TTCCCGTTGTATATGGATG
GTTCCTATGATGATGGGTC -> TTCCTATGATGATGGGTCA
GTTCGCGTGACGTCGGGAC -> TTCGCGTGACGTCGGGACG
GTTCGGGCAACAAGATCTG -> TTCGGGCAACAAGATCTGG
GTTCGGTACGGGCGTTCGG -> TTCGGTACGGGCGTTCGGG
GTTCGTAAGTCTTGAGGAT -> TTCGTAAGTCTTGAGGATG
GTTCGTGTCGCGGTACTCC -> TTCGTGTCGCGGTACTCCG
GTTCTACTAATTCTCGAGA -> TTCTACTAATTCTCGAGAT
GTTCTCAAATTAGGCACGC -> TTCTCAAATTAGGCACGCC
GTTCTTATCGTCGAAGGGG -> TTCTTATCGTCGAAGGGGT
GTTGAGACTTCAAGGTTCG -> TTGAGACTTCAAGGTTCGG
GTTGATTTGGGAGAGCCGA -> TTGATTTGGGAGAGCCGAG
GTTGCAGATTGGCTGTATA -> TTGCAGATTGGCTGTATAG
GTTGCCAGGGCTGTTACGT -> TTGCCAGGGCTGTTACGTT
GTTGCGCACAACTTCCGGA -> TTGCGCACAACTTCCGGAC
GTTGGATAGGATAACGTTT -> TTGGATAGGATAACGTTTA
GTTGGCGGCGTCATATAAT -> TTGGCGGCGTCATATAATA
GTTGGCTAGGGTGCGGAGA -> TTGGCTAGGGTGCGGAGAA
GTTGTATATGGATGCATTT -> TTGTATATGGATGCATTTC
GTTTAAAACTAGTCTCATT -> TTTAAAACTAGTCTCATTG
GTTTACGTTAAGCGTTGAG -> TTTACGTTAAGCGTTGAGA
GTTTAGCGGTGCCAGGCTC -> TTTAGCGGTGCCAGGCTCC
GTTTAGGGCCAAACTAAAC -> TTTAGGGCCAAACTAAACT
GTTTATCCAGCTCGAGCCC -> TTTATCCAGCTCGAGCCCC
GTTTATCCATGGGGGACAT -> TTTATCCATGGGGGACATA
GTTTTTCCCGGGATGCCTT -> TTTTTCCCGGGATGCCTTC
TAAAACACAGTGTCACTAT -> AAAACACAGTGTCACTATC
TAAAACGCTCAGTGTGAAG -> AAAACGCTCAGTGTGAAGA
TAAAACTAGTCTCATTGTA -> AAAACTAGTCTCATTGTAC
TAAACTATTACAAGAGCCG -> AAACTATTACAAGAGCCGG
TAAAGAGGCCAGCCGTCTT -> AAAGAGGCCAGCCGTCTTA
TAAATACGTTATGGCCTAG -> AAATACGTTATGGCCTAGG
TAAATCACAGCTTGGTATT -> AAATCACAGCTTGGTATTT
TAAATCCTATCGGCCGAAG -> AAATCCTATCGGCCGAAGC
TAAATTCCCAGAAGGGAGT -> AAATTCCCAGAAGGGAGTG
TAACAATGCAGGCCCTCAA -> AACAATGCAGGCCCTCAAC
TAACACCACCGGAGGTATA -> AACACCACCGGAGGTATAT
TAACATGCCCACCATCAAG -> AACATGCCCACCATCAAGT
TAACATTTCCTTCATCCTC -> AACATTTCCTTCATCCTCT
TAACCATCGCGACTTTGCC -> AACCATCGCGACTTTGCCG
TAACCCAGGTGTGACTACT -> AACCCAGGTGTGACTACTA
TAACCGGGGCGAGGGTCGG -> AACCGGGGCGAGGGTCGGT
TAACCTCTGACCCTCGTAT -> AACCTCTGACCCTCGTATC
TAACCTTTTTGACAGCATT -> AACCTTTTTGACAGCATTT
TAACGAGACACTCTACGTT -> AACGAGACACTCTACGTTA
TAACGTTTATCCAGCTCGA -> AACGTTTATCCAGCTCGAG
TAACTGACCGGTGCAGCCC -> AACTGACCGGTGCAGCCCT
TAAGACCACAATTTACCCC -> AAGACCACAATTTACCCCG
TAAGCCGGTTCGTGTCGCG -> AAGCCGGTTCGTGTCGCGG
TAAGCGTTGAGACTTCAAG -> AAGCGTTGAGACTTCAAGG
TAAGGTAATAGCCTCGGGA -> AAGGTAATAGCCTCGGGAC
TAAGTCATATGATCATCTG -> AAGTCATATGATCATCTGA
TAAGTCGGCTGATCCTCAA -> AAGTCGGCTGATCCTCAAC
TAAGTCTTGAGGATGTTGG -> AAGTCTTGAGGATGTTGGA
TAAGTGAGTTATGTTACGC -> AAGTGAGTTATGTTACGCG
TAATAAGACCACAATTTAC -> AATAAGACCACAATTTACC
TAATACATAAAACACAGTG -> AATACATAAAACACAGTGT
TAATAGCCTCGGGACTAGC -> AATAGCCTCGGGACTAGCC
TAATATATTCTAGTCAGGG -> AATATATTCTAGTCAGGGT
TAATATCGAGTCGGCCCGA -> AATATCGAGTCGGCCCGAG
TAATCACTTCGAACACGGT -> AATCACTTCGAACACGGTC
TAATGGCTGGCTCTCAATG -> AATGGCTGGCTCTCAATGT
TAATTCTCGAGATAATACA -> AATTCTCGAGATAATACAT
TACAAGAGCCGGATGGATC -> ACAAGAGCCGGATGGATCC
TACACCCCGGTAACACCAC -> ACACCCCGGTAACACCACC
TACACCGGCGATGGGTGAG -> ACACCGGCGATGGGTGAGC
TACAGCAGTTCTACTAATT -> ACAGCAGTTCTACTAATTC
TACAGCGCGTTTAGGGCCA -> ACAGCGCGTTTAGGGCCAA
TACAGGTCCAAGATACGAC -> ACAGGTCCAAGATACGACA
TACATAAAACACAGTGTCA -> ACATAAAACACAGTGTCAC
TACCCATTAGTGCCAGAGA -> ACCCATTAGTGCCAGAGAC
TACCCCGGTGTCTTCGCAG -> ACCCCGGTGTCTTCGCAGT
TACCCGCTCCTTTCAGCGG -> ACCCGCTCCTTTCAGCGGG
TACCCTGGAGTGTACACCC -> ACCCTGGAGTGTACACCCC
TACCGACCTGGTAAAGAGG -> ACCGACCTGGTAAAGAGGC
TACCTCTAATGGCTGGCTC -> ACCTCTAATGGCTGGCTCT
TACGACAATTCGTCTTGAT -> ACGACAATTCGTCTTGATC
TACGCAGGACTTTTTGACA -> ACGCAGGACTTTTTGACAG
TACGCGCCTTTATCCAGAC -> ACGCGCCTTTATCCAGACT
TACGGGCGTCGACGAAATC -> ACGGGCGTCGACGAAATCG
TACGGGCGTTCGGGCAACA -> ACGGGCGTTCGGGCAACAA
TACGGTGTAAATCACAGCT -> ACGGTGTAAATCACAGCTT
TACGTGGTAGAATAACCAT -> ACGTGGTAGAATAACCATC
TACGTTAAGCGTTGAGACT -> ACGTTAAGCGTTGAGACTT
TACGTTAATATATTCTAGT -> ACGTTAATATATTCTAGTC
TACGTTATGGCCTAGGAGA -> ACGTTATGGCCTAGGAGAA
TACGTTTACGTTAAGCGTT -> ACGTTTACGTTAAGCGTTG
TACTAATTCTCGAGATAAT -> ACTAATTCTCGAGATAATA
TACTAGATTGCGCTCACAT -> ACTAGATTGCGCTCACATG
TACTCCGAACATTAAAACG -> ACTCCGAACATTAAAACGC
TACTGACTGACTCGCTCAG -> ACTGACTGACTCGCTCAGT
TACTGTCGCGCTTGTCCAA -> ACTGTCGCGCTTGTCCAAA
TACTTTATGAGTGATGAGT -> ACTTTATGAGTGATGAGTG
TACTTTCCACTTTTTTGAC -> ACTTTCCACTTTTTTGACA
TACTTTGATTGCAGTTTAA -> ACTTTGATTGCAGTTTAAA
TAGAAGTCAACGTGGACTA -> AGAAGTCAACGTGGACTAA
TAGAATAACCATCGCGACT -> AGAATAACCATCGCGACTT
TAGACTGTTATGAACACTT -> AGACTGTTATGAACACTTC
TAGAGGAACAATAGTACCG -> AGAGGAACAATAGTACCGA
TAGATCTCACAGTTCTTAT -> AGATCTCACAGTTCTTATC
TAGATTGCGCTCACATGGT -> AGATTGCGCTCACATGGTA
TAGCCCCACAAAACAGACA -> AGCCCCACAAAACAGACAT
TAGCCGGTATCTAAGTCGG -> AGCCGGTATCTAAGTCGGC
TAGCCTCGGGACTAGCCGG -> AGCCTCGGGACTAGCCGGT
TAGCGGTGCCAGGCTCCCG -> AGCGGTGCCAGGCTCCCGT
TAGCTTCGGTCTTGTTCGC -> AGCTTCGGTCTTGTTCGCG
TAGGAGAACGCTAGTGTAT -> AGGAGAACGCTAGTGTATT
TAGGAGCCTTTGTCGTTAT -> AGGAGCCTTTGTCGTTATT
TAGGATAACGTTTATCCAG -> AGGATAACGTTTATCCAGC
TAGGCACGCCATTTAAATA -> AGGCACGCCATTTAAATAC
TAGGCCAGCTGAGGTTATA -> AGGCCAGCTGAGGTTATAC
TAGGGCAGTCAATGTGGTT -> AGGGCAGTCAATGTGGTTT
TAGGGCCAAACTAAACTAT -> AGGGCCAAACTAAACTATT
TAGGGCGACAGCAGTGTCA -> AGGGCGACAGCAGTGTCAT
TAGGGGGTTGATTTGGGAG -> AGGGGGTTGATTTGGGAGA
TAGGGTGCGGAGAAACCGC -> AGGGTGCGGAGAAACCGCG
TAGGTGTGATGGATGATAA -> AGGTGTGATGGATGATAAC
TAGTACCGACCTGGTAAAG -> AGTACCGACCTGGTAAAGA
TAGTCAGGGTGATATTTTT -> AGTCAGGGTGATATTTTTA
TAGTCTCATTGTACCCATT -> AGTCTCATTGTACCCATTA
TAGTGCCAGAGACGAGTAA -> AGTGCCAGAGACGAGTAAT
TAGTGCGAAAATAACCTCT -> AGTGCGAAAATAACCTCTG
TAGTGTATTTGTCGCGCTT -> AGTGTATTTGTCGCGCTTG
TAGTTATTTGTCCGTACCC -> AGTTATTTGTCCGTACCCG
TATAAGTCATATGATCATC -> ATAAGTCATATGATCATCT
TATAATAAGACCACAATTT -> ATAATAAGACCACAATTTA
TATACAGCAGTTCTACTAA -> ATACAGCAGTTCTACTAAT
TATAGGCCAGCTGAGGTTA -> ATAGGCCAGCTGAGGTTAT
TATATCAAAGCTCTCCCGT -> ATATCAAAGCTCTCCCGTG
TATATGGATGCATTTCTAT -> ATATGGATGCATTTCTATG
TATATTCTAGTCAGGGTGA -> ATATTCTAGTCAGGGTGAT
TATATTTAAATCCTATCGG -> ATATTTAAATCCTATCGGC
TATCAAAGCTCTCCCGTGT -> ATCAAAGCTCTCCCGTGTA
TATCCAGACTCTGAGACCC -> ATCCAGACTCTGAGACCCC
TATCCAGCTCGAGCCCCAA -> ATCCAGCTCGAGCCCCAAG
TATCCATGGGGGACATAGA -> ATCCATGGGGGACATAGAC
TATCCCCGGAGGCCTATAA -> ATCCCCGGAGGCCTATAAG
TATCGACTTAACATTTCCT -> ATCGACTTAACATTTCCTT
TATCGAGTCGGCCCGAGCA -> ATCGAGTCGGCCCGAGCAA
TATCGGCCGAAGCCCTGCT -> ATCGGCCGAAGCCCTGCTT
TATCGTCGAAGGGGTGAGT -> ATCGTCGAAGGGGTGAGTA
TATCTAAGTCGGCTGATCC -> ATCTAAGTCGGCTGATCCT
TATGAACACTTCCGAATCC -> ATGAACACTTCCGAATCCA
TATGAGTGATGAGTGACTA -> ATGAGTGATGAGTGACTAG
TATGATCATCTGACAGCGC -> ATGATCATCTGACAGCGCT
TATGATGATGGGTCATCTG -> ATGATGATGGGTCATCTGC
TATGGATGCATTTCTATGT -> ATGGATGCATTTCTATGTG
TATGGCCTAGGAGAACGCT -> ATGGCCTAGGAGAACGCTA
TATGGTACAGGTCCAAGAT -> ATGGTACAGGTCCAAGATA
TATGTGTTTAGCGGTGCCA -> ATGTGTTTAGCGGTGCCAG
TATGTTACGCGCCTTTATC -> ATGTTACGCGCCTTTATCC
TATGTTAGGGCAGTCAATG -> ATGTTAGGGCAGTCAATGT
TATTACAAGAGCCGGATGG -> ATTACAAGAGCCGGATGGA
TATTAGGGGGTTGATTTGG -> ATTAGGGGGTTGATTTGGG
TATTCTAGTCAGGGTGATA -> ATTCTAGTCAGGGTGATAT
TATTTAAATCCTATCGGCC -> ATTTAAATCCTATCGGCCG
TATTTGTCCGTACCCGCTC -> ATTTGTCCGTACCCGCTCC
TATTTGTCGCGCTTGTCCA -> ATTTGTCGCGCTTGTCCAA
TATTTTGAACTGGGTCGAC -> ATTTTGAACTGGGTCGACC
TATTTTTAACTGACCGGTG -> ATTTTTAACTGACCGGTGC
TCAAAGCTCTCCCGTGTAC -> CAAAGCTCTCCCGTGTACT
TCAAATTAGGCACGCCATT -> CAAATTAGGCACGCCATTT
TCAACGTGGACTAAGTGAG -> CAACGTGGACTAAGTGAGT
TCAACGTGTCGCGCTTGTC -> CAACGTGTCGCGCTTGTCC
TCAACTGTTCTCAAATTAG -> CAACTGTTCTCAAATTAGG
TCAAGGTTCGGTACGGGCG -> CAAGGTTCGGTACGGGCGT
TCAAGTTCGTAAGTCTTGA -> CAAGTTCGTAAGTCTTGAG
TCAATACGGGCGTCGACGA -> CAATACGGGCGTCGACGAA
TCAATGTCGCGCTTGTCCA -> CAATGTCGCGCTTGTCCAA
TCAATGTGGTTTTTCCCGG -> CAATGTGGTTTTTCCCGGG
TCACAAATCACTCGAGAGG -> CACAAATCACTCGAGAGGA
TCACAGCTTGGTATTTTGA -> CACAGCTTGGTATTTTGAA
TCACAGTTCTTATCGTCGA -> CACAGTTCTTATCGTCGAA
TCACATGGTAGCCCCACAA -> CACATGGTAGCCCCACAAA
TCACCATCGCCACGGTCGA -> CACCATCGCCACGGTCGAG
TCACGGTGGATCGTTGCGC -> CACGGTGGATCGTTGCGCA
TCACTATCCCCGGAGGCCT -> CACTATCCCCGGAGGCCTA
TCACTCGAGAGGAGAAGCT -> CACTCGAGAGGAGAAGCTT
TCACTTCGAACACGGTCCT -> CACTTCGAACACGGTCCTA
TCAGACCAGCGTAGGTGTG -> CAGACCAGCGTAGGTGTGA
TCAGCGGGCACGTGGAGAA -> CAGCGGGCACGTGGAGAAC
TCAGGGTGATATTTTTAAC -> CAGGGTGATATTTTTAACT
TCAGTCCTAGAGGAACAAT -> CAGTCCTAGAGGAACAATA
TCAGTGTGAAGAGTGAACG -> CAGTGTGAAGAGTGAACGT
TCATAGTTATTTGTCCGTA -> CATAGTTATTTGTCCGTAC
TCATATAATAAGACCACAA -> CATATAATAAGACCACAAT
TCATATGATCATCTGACAG -> CATATGATCATCTGACAGC
TCATCCTCTTGATATGTTA -> CATCCTCTTGATATGTTAG
TCATCTGACAGCGCTCGAT -> CATCTGACAGCGCTCGATC
TCATCTGCGTAGCTTCGGT -> CATCTGCGTAGCTTCGGTC
TCATCTGGGGTGATAACCG -> CATCTGGGGTGATAACCGG
TCATTGTACCCATTAGTGC -> CATTGTACCCATTAGTGCC
TCATTTTTGACAGCATTTG -> CATTTTTGACAGCATTTGT
TCCAAACAGCTGCCGTCAT -> CCAAACAGCTGCCGTCATT
TCCAAACCTACGCAGGACT -> CCAAACCTACGCAGGACTT
TCCAAACGAGGTCTAACCT -> CCAAACGAGGTCTAACCTT
TCCAAACTACTTTCCACTT -> CCAAACTACTTTCCACTTT
TCCAAGATACGACAATTCG -> CCAAGATACGACAATTCGT
TCCACTTTTTTGACAGCAT -> CCACTTTTTTGACAGCATT
TCCAGACTCTGAGACCCCT -> CCAGACTCTGAGACCCCTG
TCCAGCTCGAGCCCCAAGG -> CCAGCTCGAGCCCCAAGGG
TCCATGGGGGACATAGACT -> CCATGGGGGACATAGACTG
TCCATTCACGGTGGATCGT -> CCATTCACGGTGGATCGTT
TCCCAGAAGGGAGTGAGCC -> CCCAGAAGGGAGTGAGCCC
TCCCCGGAGGCCTATAAGT -> CCCCGGAGGCCTATAAGTC
TCCCGCAGTTCAATACGGG -> CCCGCAGTTCAATACGGGC
TCCCGGGATGCCTTCTGCT -> CCCGGGATGCCTTCTGCTG
TCCCGTGGCAATAACGAGA -> CCCGTGGCAATAACGAGAC
TCCCGTGTACTTTGATTGC -> CCCGTGTACTTTGATTGCA
TCCCGTTGTATATGGATGC -> CCCGTTGTATATGGATGCA
TCCGAACATTAAAACGCTC -> CCGAACATTAAAACGCTCA
TCCGAACGGTGTACCCTGG -> CCGAACGGTGTACCCTGGA
TCCGAATCCATTCACGGTG -> CCGAATCCATTCACGGTGG
TCCGAGCCCTACTGTCGCG -> CCGAGCCCTACTGTCGCGC
TCCGGACTAAATTCCCAGA -> CCGGACTAAATTCCCAGAA
TCCGTACCCGCTCCTTTCA -> CCGTACCCGCTCCTTTCAG
TCCGTCGGCTGGAGGTACG -> CCGTCGGCTGGAGGTACGG
TCCTACTGACTGACTCGCT -> CCTACTGACTGACTCGCTC
TCCTAGAGGAACAATAGTA -> CCTAGAGGAACAATAGTAC
TCCTAGGAGCCTTTGTCGT -> CCTAGGAGCCTTTGTCGTT
TCCTATCGGCCGAAGCCCT -> CCTATCGGCCGAAGCCCTG
TCCTATGATGATGGGTCAT -> CCTATGATGATGGGTCATC
TCCTCAACTGTTCTCAAAT -> CCTCAACTGTTCTCAAATT
TCCTCTTGATATGTTAGGG -> CCTCTTGATATGTTAGGGC
TCCTTCATCCTCTTGATAT -> CCTTCATCCTCTTGATATG
TCCTTCCGAACGGTGTACC -> CCTTCCGAACGGTGTACCC
TCCTTTCAGCGGGCACGTG -> CCTTTCAGCGGGCACGTGG
TCGAACACGGTCCTAGGAG -> CGAACACGGTCCTAGGAGC
TCGAAGGGGTGAGTATATT -> CGAAGGGGTGAGTATATTT
TCGACCCGGCTAGAAGTGT -> CGACCCGGCTAGAAGTGTG
TCGACCGTACCTCTAATGG -> CGACCGTACCTCTAATGGC
TCGACGAAATCGGGACACA -> CGACGAAATCGGGACACAC
TCGACTTAACATTTCCTTC -> CGACTTAACATTTCCTTCA
TCGAGAGCGTTTATCCATG -> CGAGAGCGTTTATCCATGG
TCGAGAGGAGAAGCTTGGA -> CGAGAGGAGAAGCTTGGAT
TCGAGATAATACATAAAAC -> CGAGATAATACATAAAACA
TCGAGCCCCAAGGGGGACC -> CGAGCCCCAAGGGGGACCT
TCGAGTCGGCCCGAGCAAC -> CGAGTCGGCCCGAGCAACT
TCGATCCGAGCCCTACTGT -> CGATCCGAGCCCTACTGTC
TCGCAGTGAACACGGCATC -> CGCAGTGAACACGGCATCT
TCGCCACGGTCGAGAGCGT -> CGCCACGGTCGAGAGCGTT
TCGCCACTGGTGTCTACTT -> CGCCACTGGTGTCTACTTT
TCGCGACTTTGCCGTCCGT -> CGCGACTTTGCCGTCCGTC
TCGCGCTTGTCCAAACAGC -> CGCGCTTGTCCAAACAGCT
TCGCGCTTGTCCAAACCTA -> CGCGCTTGTCCAAACCTAC
TCGCGCTTGTCCAAACGAG -> CGCGCTTGTCCAAACGAGG
TCGCGCTTGTCCAAACTAC -> CGCGCTTGTCCAAACTACT
TCGCGGTACTCCGAACATT -> CGCGGTACTCCGAACATTA
TCGCGTGACGTCGGGACGC -> CGCGTGACGTCGGGACGCC
TCGCTCAGTCCTAGAGGAA -> CGCTCAGTCCTAGAGGAAC
TCGGCCCGAGCAACTCCTT -> CGGCCCGAGCAACTCCTTC
TCGGCCGAAGCCCTGCTTC -> CGGCCGAAGCCCTGCTTCA
TCGGCTGATCCTCAACTGT -> CGGCTGATCCTCAACTGTT
TCGGCTGGAGGTACGGTGT -> CGGCTGGAGGTACGGTGTA
TCGGGACACACGAACTCTC -> CGGGACACACGAACTCTCG
TCGGGACGCCGATTGCGGT -> CGGGACGCCGATTGCGGTG
TCGGGACTAGCCGGTATCT -> CGGGACTAGCCGGTATCTA
TCGGGCAACAAGATCTGGT -> CGGGCAACAAGATCTGGTA
TCGGTACGGGCGTTCGGGC -> CGGTACGGGCGTTCGGGCA
TCGGTCTTGTTCGCGTGAC -> CGGTCTTGTTCGCGTGACG
TCGGTGTGTTAGATCTCAC -> CGGTGTGTTAGATCTCACA
TCGTAAGTCTTGAGGATGT -> CGTAAGTCTTGAGGATGTT
TCGTATCGACTTAACATTT -> CGTATCGACTTAACATTTC
TCGTCGAAGGGGTGAGTAT -> CGTCGAAGGGGTGAGTATA
TCGTCTTGATCTGCGTCCT -> CGTCTTGATCTGCGTCCTA
TCGTGTCGCGGTACTCCGA -> CGTGTCGCGGTACTCCGAA
TCGTTATTAGGGGGTTGAT -> CGTTATTAGGGGGTTGATT
TCGTTGCGCACAACTTCCG -> CGTTGCGCACAACTTCCGG
TCTAACCTTTTTGACAGCA -> CTAACCTTTTTGACAGCAT
TCTAAGTCGGCTGATCCTC -> CTAAGTCGGCTGATCCTCA
TCTAATGGCTGGCTCTCAA -> CTAATGGCTGGCTCTCAAT
TCTACGTTAATATATTCTA -> CTACGTTAATATATTCTAG
TCTACTAATTCTCGAGATA -> CTACTAATTCTCGAGATAA
TCTACTTTATGAGTGATGA -> CTACTTTATGAGTGATGAG
TCTAGTCAGGGTGATATTT -> CTAGTCAGGGTGATATTTT
TCTATGGTACAGGTCCAAG -> CTATGGTACAGGTCCAAGA
TCTATGTGTTTAGCGGTGC -> CTATGTGTTTAGCGGTGCC
TCTCAAATTAGGCACGCCA -> CTCAAATTAGGCACGCCAT
TCTCAATGTCGCGCTTGTC -> CTCAATGTCGCGCTTGTCC
TCTCACAGTTCTTATCGTC -> CTCACAGTTCTTATCGTCG
TCTCATTGTACCCATTAGT -> CTCATTGTACCCATTAGTG
TCTCCCGTGTACTTTGATT -> CTCCCGTGTACTTTGATTG
TCTCGAGATAATACATAAA -> CTCGAGATAATACATAAAA
TCTCGCCACTGGTGTCTAC -> CTCGCCACTGGTGTCTACT
TCTCTGTAAGCCGGTTCGT -> CTCTGTAAGCCGGTTCGTG
TCTGACAGCGCTCGATCCG -> CTGACAGCGCTCGATCCGA
TCTGACCCTCGTATCGACT -> CTGACCCTCGTATCGACTT
TCTGAGACCCCTGTGGATC -> CTGAGACCCCTGTGGATCA
TCTGCGTAGCTTCGGTCTT -> CTGCGTAGCTTCGGTCTTG
TCTGCGTCCTACTGACTGA -> CTGCGTCCTACTGACTGAC
TCTGCTGGCTTACGTGGTA -> CTGCTGGCTTACGTGGTAG
TCTGGGGTGATAACCGGGG -> CTGGGGTGATAACCGGGGC
TCTGGTAACATGCCCACCA -> CTGGTAACATGCCCACCAT
TCTGTAAGCCGGTTCGTGT -> CTGTAAGCCGGTTCGTGTC
TCTTAGGGCGACAGCAGTG -> CTTAGGGCGACAGCAGTGT
TCTTATCGTCGAAGGGGTG -> CTTATCGTCGAAGGGGTGA
TCTTCGCAGTGAACACGGC -> CTTCGCAGTGAACACGGCA
TCTTGAGGATGTTGGATAG -> CTTGAGGATGTTGGATAGG
TCTTGATATGTTAGGGCAG -> CTTGATATGTTAGGGCAGT
TCTTGATCTGCGTCCTACT -> CTTGATCTGCGTCCTACTG
TCTTGTTCGCGTGACGTCG -> CTTGTTCGCGTGACGTCGG
TCTTTCGACCGTACCTCTA -> CTTTCGACCGTACCTCTAA
TGAACACGGCATCTATGGT -> GAACACGGCATCTATGGTA
TGAACACTTCCGAATCCAT -> GAACACTTCCGAATCCATT
TGAACGTTAGTGCGAAAAT -> GAACGTTAGTGCGAAAATA
TGAACTGGGTCGACCCGGC -> GAACTGGGTCGACCCGGCT
TGAAGAGTGAACGTTAGTG -> GAAGAGTGAACGTTAGTGC
TGACAGCATTTGTTGCAGA -> GACAGCATTTGTTGCAGAT
TGACAGCATTTGTTGCCAG -> GACAGCATTTGTTGCCAGG
TGACAGCATTTGTTGGCGG -> GACAGCATTTGTTGGCGGC
TGACAGCATTTGTTGGCTA -> GACAGCATTTGTTGGCTAG
TGACAGCGCTCGATCCGAG -> GACAGCGCTCGATCCGAGC
TGACCCTCGTATCGACTTA -> GACCCTCGTATCGACTTAA
TGACCGGTGCAGCCCTTAC -> GACCGGTGCAGCCCTTACA
TGACGTCGGGACGCCGATT -> GACGTCGGGACGCCGATTG
TGACTACTAGATTGCGCTC -> GACTACTAGATTGCGCTCA
TGACTAGAAGTCAACGTGG -> GACTAGAAGTCAACGTGGA
TGACTCGCTCAGTCCTAGA -> GACTCGCTCAGTCCTAGAG
TGACTGACTCGCTCAGTCC -> GACTGACTCGCTCAGTCCT
TGAGACCCCTGTGGATCAT -> GAGACCCCTGTGGATCATC
TGAGACTTCAAGGTTCGGT -> GAGACTTCAAGGTTCGGTA
TGAGCCCCCGCGCAGCACT -> GAGCCCCCGCGCAGCACTC
TGAGCTCACAAATCACTCG -> GAGCTCACAAATCACTCGA
TGAGGATGTTGGATAGGAT -> GAGGATGTTGGATAGGATA
TGAGGTGTTCCCGTTGTAT -> GAGGTGTTCCCGTTGTATA
TGAGGTTATACAGCAGTTC -> GAGGTTATACAGCAGTTCT
TGAGTACAGCGCGTTTAGG -> GAGTACAGCGCGTTTAGGG
TGAGTATATTTAAATCCTA -> GAGTATATTTAAATCCTAT
TGAGTGACTAGAAGTCAAC -> GAGTGACTAGAAGTCAACG
TGAGTGATGAGTGACTAGA -> GAGTGATGAGTGACTAGAA
TGAGTTATGTTACGCGCCT -> GAGTTATGTTACGCGCCTT
TGATAACCCAGGTGTGACT -> GATAACCCAGGTGTGACTA
TGATAACCGGGGCGAGGGT -> GATAACCGGGGCGAGGGTC
TGATATGTTAGGGCAGTCA -> GATATGTTAGGGCAGTCAA
TGATATTTTTAACTGACCG -> GATATTTTTAACTGACCGG
TGATCATCTGACAGCGCTC -> GATCATCTGACAGCGCTCG
TGATCCTCAACTGTTCTCA -> GATCCTCAACTGTTCTCAA
TGATCTGCGTCCTACTGAC -> GATCTGCGTCCTACTGACT
TGATGAGTGACTAGAAGTC -> GATGAGTGACTAGAAGTCA
TGATGATGGGTCATCTGCG -> GATGATGGGTCATCTGCGT
TGATGGATGATAACCCAGG -> GATGGATGATAACCCAGGT
TGATGGGTCATCTGCGTAG -> GATGGGTCATCTGCGTAGC
TGATTGCAGTTTAAAACTA -> GATTGCAGTTTAAAACTAG
TGATTTGGGAGAGCCGAGT -> GATTTGGGAGAGCCGAGTG
TGCAGATTGGCTGTATAGG -> GCAGATTGGCTGTATAGGC
TGCAGCCCTTACACCGGCG -> GCAGCCCTTACACCGGCGA
TGCAGGCCCTCAACGTGTC -> GCAGGCCCTCAACGTGTCG
TGCAGTTTAAAACTAGTCT -> GCAGTTTAAAACTAGTCTC
TGCATTTCTATGTGTTTAG -> GCATTTCTATGTGTTTAGC
TGCCAGAGACGAGTAATCA -> GCCAGAGACGAGTAATCAC
TGCCAGGCTCCCGTGGCAA -> GCCAGGCTCCCGTGGCAAT
TGCCAGGGCTGTTACGTTT -> GCCAGGGCTGTTACGTTTA
TGCCCACCATCAAGTTCGT -> GCCCACCATCAAGTTCGTA
TGCCGTCATTTTTGACAGC -> GCCGTCATTTTTGACAGCA
TGCCGTCCGTCGGCTGGAG -> GCCGTCCGTCGGCTGGAGG
TGCCTTCTGCTGGCTTACG -> GCCTTCTGCTGGCTTACGT
TGCGAAAATAACCTCTGAC -> GCGAAAATAACCTCTGACC
TGCGCACAACTTCCGGACT -> GCGCACAACTTCCGGACTA
TGCGCTCACATGGTAGCCC -> GCGCTCACATGGTAGCCCC
TGCGGAGAAACCGCGAAAT -> GCGGAGAAACCGCGAAATA
TGCGGTGGAATGAGGTGTT -> GCGGTGGAATGAGGTGTTC
TGCGTAGCTTCGGTCTTGT -> GCGTAGCTTCGGTCTTGTT
TGCGTCCTACTGACTGACT -> GCGTCCTACTGACTGACTC
TGCTGGCTTACGTGGTAGA -> GCTGGCTTACGTGGTAGAA
TGCTTCACCATCGCCACGG -> GCTTCACCATCGCCACGGT
TGGAATGAGGTGTTCCCGT -> GGAATGAGGTGTTCCCGTT
TGGACTAAGTGAGTTATGT -> GGACTAAGTGAGTTATGTT
TGGAGAACGGGTTCCTATG -> GGAGAACGGGTTCCTATGA
TGGAGGTACGGTGTAAATC -> GGAGGTACGGTGTAAATCA
TGGAGTGTACACCCCGGTA -> GGAGTGTACACCCCGGTAA
TGGATAGGATAACGTTTAT -> GGATAGGATAACGTTTATC
TGGATCATCTGGGGTGATA -> GGATCATCTGGGGTGATAA
TGGATCCCGCAGTTCAATA -> GGATCCCGCAGTTCAATAC
TGGATCGTTGCGCACAACT -> GGATCGTTGCGCACAACTT
TGGATGATAACCCAGGTGT -> GGATGATAACCCAGGTGTG
TGGATGCATTTCTATGTGT -> GGATGCATTTCTATGTGTT
TGGATGTAATATCGAGTCG -> GGATGTAATATCGAGTCGG
TGGCAATAACGAGACACTC -> GGCAATAACGAGACACTCT
TGGCCTAGGAGAACGCTAG -> GGCCTAGGAGAACGCTAGT
TGGCGGCGTCATATAATAA -> GGCGGCGTCATATAATAAG
TGGCTAGGGTGCGGAGAAA -> GGCTAGGGTGCGGAGAAAC
TGGCTCTCAATGTCGCGCT -> GGCTCTCAATGTCGCGCTT
TGGCTGGCTCTCAATGTCG -> GGCTGGCTCTCAATGTCGC
TGGCTGTATAGGCCAGCTG -> GGCTGTATAGGCCAGCTGA
TGGCTTACGTGGTAGAATA -> GGCTTACGTGGTAGAATAA
TGGGAGAGCCGAGTGTCTC -> GGGAGAGCCGAGTGTCTCT
TGGGGGACATAGACTGTTA -> GGGGGACATAGACTGTTAT
TGGGGTGATAACCGGGGCG -> GGGGTGATAACCGGGGCGA
TGGGTCATCTGCGTAGCTT -> GGGTCATCTGCGTAGCTTC
TGGGTCGACCCGGCTAGAA -> GGGTCGACCCGGCTAGAAG
TGGGTGAGCTCACAAATCA -> GGGTGAGCTCACAAATCAC
TGGTAAAGAGGCCAGCCGT -> GGTAAAGAGGCCAGCCGTC
TGGTAACATGCCCACCATC -> GGTAACATGCCCACCATCA
TGGTACAGGTCCAAGATAC -> GGTACAGGTCCAAGATACG
TGGTAGAATAACCATCGCG -> GGTAGAATAACCATCGCGA
TGGTAGCCCCACAAAACAG -> GGTAGCCCCACAAAACAGA
TGGTATTTTGAACTGGGTC -> GGTATTTTGAACTGGGTCG
TGGTGTCTACTTTATGAGT -> GGTGTCTACTTTATGAGTG
TGGTTTTTCCCGGGATGCC -> GGTTTTTCCCGGGATGCCT
TGTAAATCACAGCTTGGTA -> GTAAATCACAGCTTGGTAT
TGTAAGCCGGTTCGTGTCG -> GTAAGCCGGTTCGTGTCGC
TGTAATATCGAGTCGGCCC -> GTAATATCGAGTCGGCCCG
TGTACACCCCGGTAACACC -> GTACACCCCGGTAACACCA
TGTACCCATTAGTGCCAGA -> GTACCCATTAGTGCCAGAG
TGTACCCTGGAGTGTACAC -> GTACCCTGGAGTGTACACC
TGTACTTTGATTGCAGTTT -> GTACTTTGATTGCAGTTTA
TGTATAGGCCAGCTGAGGT -> GTATAGGCCAGCTGAGGTT
TGTATATGGATGCATTTCT -> GTATATGGATGCATTTCTA
TGTATTTGTCGCGCTTGTC -> GTATTTGTCGCGCTTGTCC
TGTCACTATCCCCGGAGGC -> GTCACTATCCCCGGAGGCC
TGTCATAGTTATTTGTCCG -> GTCATAGTTATTTGTCCGT
TGTCCAAACAGCTGCCGTC -> GTCCAAACAGCTGCCGTCA
TGTCCAAACCTACGCAGGA -> GTCCAAACCTACGCAGGAC
TGTCCAAACGAGGTCTAAC -> GTCCAAACGAGGTCTAACC
TGTCCAAACTACTTTCCAC -> GTCCAAACTACTTTCCACT
TGTCCGTACCCGCTCCTTT -> GTCCGTACCCGCTCCTTTC
TGTCGCGCTTGTCCAAACA -> GTCGCGCTTGTCCAAACAG
TGTCGCGCTTGTCCAAACC -> GTCGCGCTTGTCCAAACCT
TGTCGCGCTTGTCCAAACG -> GTCGCGCTTGTCCAAACGA
TGTCGCGCTTGTCCAAACT -> GTCGCGCTTGTCCAAACTA
TGTCGCGGTACTCCGAACA -> GTCGCGGTACTCCGAACAT
TGTCGTTATTAGGGGGTTG -> GTCGTTATTAGGGGGTTGA
TGTCTACTTTATGAGTGAT -> GTCTACTTTATGAGTGATG
TGTCTCTGTAAGCCGGTTC -> GTCTCTGTAAGCCGGTTCG
TGTCTTCGCAGTGAACACG -> GTCTTCGCAGTGAACACGG
TGTGAAGAGTGAACGTTAG -> GTGAAGAGTGAACGTTAGT
TGTGACTACTAGATTGCGC -> GTGACTACTAGATTGCGCT
TGTGATGGATGATAACCCA -> GTGATGGATGATAACCCAG
TGTGGATCATCTGGGGTGA -> GTGGATCATCTGGGGTGAT
TGTGGTTTTTCCCGGGATG -> GTGGTTTTTCCCGGGATGC
TGTGTTAGATCTCACAGTT -> GTGTTAGATCTCACAGTTC
TGTGTTTAGCGGTGCCAGG -> GTGTTTAGCGGTGCCAGGC
TGTTACGCGCCTTTATCCA -> GTTACGCGCCTTTATCCAG
TGTTACGTTTACGTTAAGC -> GTTACGTTTACGTTAAGCG
TGTTAGATCTCACAGTTCT -> GTTAGATCTCACAGTTCTT
TGTTAGGGCAGTCAATGTG -> GTTAGGGCAGTCAATGTGG
TGTTATGAACACTTCCGAA -> GTTATGAACACTTCCGAAT
TGTTCCCGTTGTATATGGA -> GTTCCCGTTGTATATGGAT
TGTTCGCGTGACGTCGGGA -> GTTCGCGTGACGTCGGGAC
TGTTCTCAAATTAGGCACG -> GTTCTCAAATTAGGCACGC
TGTTGCAGATTGGCTGTAT -> GTTGCAGATTGGCTGTATA
TGTTGCCAGGGCTGTTACG -> GTTGCCAGGGCTGTTACGT
TGTTGGATAGGATAACGTT -> GTTGGATAGGATAACGTTT
TGTTGGCGGCGTCATATAA -> GTTGGCGGCGTCATATAAT
TGTTGGCTAGGGTGCGGAG -> GTTGGCTAGGGTGCGGAGA
TGTTTAGCGGTGCCAGGCT -> GTTTAGCGGTGCCAGGCTC
TTAAAACGCTCAGTGTGAA -> TAAAACGCTCAGTGTGAAG
TTAAAACTAGTCTCATTGT -> TAAAACTAGTCTCATTGTA
TTAAATACGTTATGGCCTA -> TAAATACGTTATGGCCTAG
TTAAATCCTATCGGCCGAA -> TAAATCCTATCGGCCGAAG
TTAACATTTCCTTCATCCT -> TAACATTTCCTTCATCCTC
TTAACTGACCGGTGCAGCC -> TAACTGACCGGTGCAGCCC
TTAAGCGTTGAGACTTCAA -> TAAGCGTTGAGACTTCAAG
TTAATATATTCTAGTCAGG -> TAATATATTCTAGTCAGGG
TTACAAGAGCCGGATGGAT -> TACAAGAGCCGGATGGATC
TTACACCGGCGATGGGTGA -> TACACCGGCGATGGGTGAG
TTACCCCGGTGTCTTCGCA -> TACCCCGGTGTCTTCGCAG
TTACGCGCCTTTATCCAGA -> TACGCGCCTTTATCCAGAC
TTACGTGGTAGAATAACCA -> TACGTGGTAGAATAACCAT
TTACGTTAAGCGTTGAGAC -> TACGTTAAGCGTTGAGACT
TTACGTTTACGTTAAGCGT -> TACGTTTACGTTAAGCGTT
TTAGATCTCACAGTTCTTA -> TAGATCTCACAGTTCTTAT
TTAGCGGTGCCAGGCTCCC -> TAGCGGTGCCAGGCTCCCG
TTAGGCACGCCATTTAAAT -> TAGGCACGCCATTTAAATA
TTAGGGCAGTCAATGTGGT -> TAGGGCAGTCAATGTGGTT
TTAGGGCCAAACTAAACTA -> TAGGGCCAAACTAAACTAT
TTAGGGCGACAGCAGTGTC -> TAGGGCGACAGCAGTGTCA
TTAGGGGGTTGATTTGGGA -> TAGGGGGTTGATTTGGGAG
TTAGTGCCAGAGACGAGTA -> TAGTGCCAGAGACGAGTAA
TTAGTGCGAAAATAACCTC -> TAGTGCGAAAATAACCTCT
TTATACAGCAGTTCTACTA -> TATACAGCAGTTCTACTAA
TTATCCAGACTCTGAGACC -> TATCCAGACTCTGAGACCC
TTATCCAGCTCGAGCCCCA -> TATCCAGCTCGAGCCCCAA
TTATCCATGGGGGACATAG -> TATCCATGGGGGACATAGA
TTATCGTCGAAGGGGTGAG -> TATCGTCGAAGGGGTGAGT
TTATGAACACTTCCGAATC -> TATGAACACTTCCGAATCC
TTATGAGTGATGAGTGACT -> TATGAGTGATGAGTGACTA
TTATGGCCTAGGAGAACGC -> TATGGCCTAGGAGAACGCT
TTATGTTACGCGCCTTTAT -> TATGTTACGCGCCTTTATC
TTATTAGGGGGTTGATTTG -> TATTAGGGGGTTGATTTGG
TTATTTGTCCGTACCCGCT -> TATTTGTCCGTACCCGCTC
TTCAAGGTTCGGTACGGGC -> TCAAGGTTCGGTACGGGCG
TTCAATACGGGCGTCGACG -> TCAATACGGGCGTCGACGA
TTCACCATCGCCACGGTCG -> TCACCATCGCCACGGTCGA
TTCACGGTGGATCGTTGCG -> TCACGGTGGATCGTTGCGC
TTCAGCGGGCACGTGGAGA -> TCAGCGGGCACGTGGAGAA
TTCATCCTCTTGATATGTT -> TCATCCTCTTGATATGTTA
TTCCACTTTTTTGACAGCA -> TCCACTTTTTTGACAGCAT
TTCCCAGAAGGGAGTGAGC -> TCCCAGAAGGGAGTGAGCC
TTCCCGGGATGCCTTCTGC -> TCCCGGGATGCCTTCTGCT
TTCCCGTTGTATATGGATG -> TCCCGTTGTATATGGATGC
TTCCGAACGGTGTACCCTG -> TCCGAACGGTGTACCCTGG
TTCCGAATCCATTCACGGT -> TCCGAATCCATTCACGGTG
TTCCGGACTAAATTCCCAG -> TCCGGACTAAATTCCCAGA
TTCCTATGATGATGGGTCA -> TCCTATGATGATGGGTCAT
TTCCTTCATCCTCTTGATA -> TCCTTCATCCTCTTGATAT
TTCGAACACGGTCCTAGGA -> TCGAACACGGTCCTAGGAG
TTCGACCGTACCTCTAATG -> TCGACCGTACCTCTAATGG
TTCGCAGTGAACACGGCAT -> TCGCAGTGAACACGGCATC
TTCGCGTGACGTCGGGACG -> TCGCGTGACGTCGGGACGC
TTCGGGCAACAAGATCTGG -> TCGGGCAACAAGATCTGGT
TTCGGTACGGGCGTTCGGG -> TCGGTACGGGCGTTCGGGC
TTCGGTCTTGTTCGCGTGA -> TCGGTCTTGTTCGCGTGAC
TTCGTAAGTCTTGAGGATG -> TCGTAAGTCTTGAGGATGT
TTCGTCTTGATCTGCGTCC -> TCGTCTTGATCTGCGTCCT
TTCGTGTCGCGGTACTCCG -> TCGTGTCGCGGTACTCCGA
TTCTACTAATTCTCGAGAT -> TCTACTAATTCTCGAGATA
TTCTAGTCAGGGTGATATT -> TCTAGTCAGGGTGATATTT
TTCTATGTGTTTAGCGGTG -> TCTATGTGTTTAGCGGTGC
TTCTCAAATTAGGCACGCC -> TCTCAAATTAGGCACGCCA
TTCTCGAGATAATACATAA -> TCTCGAGATAATACATAAA
TTCTGCTGGCTTACGTGGT -> TCTGCTGGCTTACGTGGTA
TTCTTATCGTCGAAGGGGT -> TCTTATCGTCGAAGGGGTG
TTGAACTGGGTCGACCCGG -> TGAACTGGGTCGACCCGGC
TTGACAGCATTTGTTGCAG -> TGACAGCATTTGTTGCAGA
TTGACAGCATTTGTTGCCA -> TGACAGCATTTGTTGCCAG
TTGACAGCATTTGTTGGCG -> TGACAGCATTTGTTGGCGG
TTGACAGCATTTGTTGGCT -> TGACAGCATTTGTTGGCTA
TTGAGACTTCAAGGTTCGG -> TGAGACTTCAAGGTTCGGT
TTGAGGATGTTGGATAGGA -> TGAGGATGTTGGATAGGAT
TTGATATGTTAGGGCAGTC -> TGATATGTTAGGGCAGTCA
TTGATCTGCGTCCTACTGA -> TGATCTGCGTCCTACTGAC
TTGATTGCAGTTTAAAACT -> TGATTGCAGTTTAAAACTA
TTGATTTGGGAGAGCCGAG -> TGATTTGGGAGAGCCGAGT
TTGCAGATTGGCTGTATAG -> TGCAGATTGGCTGTATAGG
TTGCAGTTTAAAACTAGTC -> TGCAGTTTAAAACTAGTCT
TTGCCAGGGCTGTTACGTT -> TGCCAGGGCTGTTACGTTT
TTGCCGTCCGTCGGCTGGA -> TGCCGTCCGTCGGCTGGAG
TTGCGCACAACTTCCGGAC -> TGCGCACAACTTCCGGACT
TTGCGCTCACATGGTAGCC -> TGCGCTCACATGGTAGCCC
TTGCGGTGGAATGAGGTGT -> TGCGGTGGAATGAGGTGTT
TTGGATAGGATAACGTTTA -> TGGATAGGATAACGTTTAT
TTGGATGTAATATCGAGTC -> TGGATGTAATATCGAGTCG
TTGGCGGCGTCATATAATA -> TGGCGGCGTCATATAATAA
TTGGCTAGGGTGCGGAGAA -> TGGCTAGGGTGCGGAGAAA
TTGGCTGTATAGGCCAGCT -> TGGCTGTATAGGCCAGCTG
TTGGGAGAGCCGAGTGTCT -> TGGGAGAGCCGAGTGTCTC
TTGGTATTTTGAACTGGGT -> TGGTATTTTGAACTGGGTC
TTGTACCCATTAGTGCCAG -> TGTACCCATTAGTGCCAGA
TTGTATATGGATGCATTTC -> TGTATATGGATGCATTTCT
TTGTCCAAACAGCTGCCGT -> TGTCCAAACAGCTGCCGTC
TTGTCCAAACCTACGCAGG -> TGTCCAAACCTACGCAGGA
TTGTCCAAACGAGGTCTAA -> TGTCCAAACGAGGTCTAAC
TTGTCCAAACTACTTTCCA -> TGTCCAAACTACTTTCCAC
TTGTCCGTACCCGCTCCTT -> TGTCCGTACCCGCTCCTTT
TTGTCGCGCTTGTCCAAAC -> TGTCGCGCTTGTCCAAACT
TTGTCGTTATTAGGGGGTT -> TGTCGTTATTAGGGGGTTG
TTGTTCGCGTGACGTCGGG -> TGTTCGCGTGACGTCGGGA
TTGTTGCAGATTGGCTGTA -> TGTTGCAGATTGGCTGTAT
TTGTTGCCAGGGCTGTTAC -> TGTTGCCAGGGCTGTTACG
TTGTTGGCGGCGTCATATA -> TGTTGGCGGCGTCATATAA
TTGTTGGCTAGGGTGCGGA -> TGTTGGCTAGGGTGCGGAG
TTTAAAACTAGTCTCATTG -> TTAAAACTAGTCTCATTGT
TTTAAATACGTTATGGCCT -> TTAAATACGTTATGGCCTA
TTTAAATCCTATCGGCCGA -> TTAAATCCTATCGGCCGAA
TTTAACTGACCGGTGCAGC -> TTAACTGACCGGTGCAGCC
TTTACCCCGGTGTCTTCGC -> TTACCCCGGTGTCTTCGCA
TTTACGTTAAGCGTTGAGA -> TTACGTTAAGCGTTGAGAC
TTTAGCGGTGCCAGGCTCC -> TTAGCGGTGCCAGGCTCCC
TTTAGGGCCAAACTAAACT -> TTAGGGCCAAACTAAACTA
TTTATCCAGACTCTGAGAC -> TTATCCAGACTCTGAGACC
TTTATCCAGCTCGAGCCCC -> TTATCCAGCTCGAGCCCCA
TTTATCCATGGGGGACATA -> TTATCCATGGGGGACATAG
TTTATGAGTGATGAGTGAC -> TTATGAGTGATGAGTGACT
TTTCAGCGGGCACGTGGAG -> TTCAGCGGGCACGTGGAGA
TTTCCACTTTTTTGACAGC -> TTCCACTTTTTTGACAGCA
TTTCCCGGGATGCCTTCTG -> TTCCCGGGATGCCTTCTGC
TTTCCTTCATCCTCTTGAT -> TTCCTTCATCCTCTTGATA
TTTCGACCGTACCTCTAAT -> TTCGACCGTACCTCTAATG
TTTCTATGTGTTTAGCGGT -> TTCTATGTGTTTAGCGGTG
TTTGAACTGGGTCGACCCG -> TTGAACTGGGTCGACCCGG
TTTGACAGCATTTGTTGCA -> TTGACAGCATTTGTTGCAG
TTTGACAGCATTTGTTGCC -> TTGACAGCATTTGTTGCCA
TTTGACAGCATTTGTTGGC -> TTGACAGCATTTGTTGGCG,TTGACAGCATTTGTTGGCT
TTTGATTGCAGTTTAAAAC -> TTGATTGCAGTTTAAAACT
TTTGCCGTCCGTCGGCTGG -> TTGCCGTCCGTCGGCTGGA
TTTGGGAGAGCCGAGTGTC -> TTGGGAGAGCCGAGTGTCT
TTTGTCCGTACCCGCTCCT -> TTGTCCGTACCCGCTCCTT
TTTGTCGCGCTTGTCCAAA -> TTGTCGCGCTTGTCCAAAC
TTTGTCGTTATTAGGGGGT -> TTGTCGTTATTAGGGGGTT
TTTGTTGCAGATTGGCTGT -> TTGTTGCAGATTGGCTGTA
TTTGTTGCCAGGGCTGTTA -> TTGTTGCCAGGGCTGTTAC
TTTGTTGGCGGCGTCATAT -> TTGTTGGCGGCGTCATATA
TTTGTTGGCTAGGGTGCGG -> TTGTTGGCTAGGGTGCGGA
TTTTAACTGACCGGTGCAG -> TTTAACTGACCGGTGCAGC
TTTTCCCGGGATGCCTTCT -> TTTCCCGGGATGCCTTCTG
TTTTGAACTGGGTCGACCC -> TTTGAACTGGGTCGACCCG
TTTTGACAGCATTTGTTGC -> TTTGACAGCATTTGTTGCA,TTTGACAGCATTTGTTGCC
TTTTGACAGCATTTGTTGG -> TTTGACAGCATTTGTTGGC,TTTGACAGCATTTGTTGGC
TTTTTAACTGACCGGTGCA -> TTTTAACTGACCGGTGCAG
TTTTTCCCGGGATGCCTTC -> TTTTCCCGGGATGCCTTCT
TTTTTGACAGCATTTGTTG -> TTTTGACAGCATTTGTTGC,TTTTGACAGCATTTGTTGC,TTTTGACAGCATTTGTTGG,TTTTGACAGCATTTGTTGG
TTTTTTGACAGCATTTGTT -> TTTTTGACAGCATTTGTTG
