AAAAGGCCCCACACCAATGT -> AAAGGCCCCACACCAATGTG
AAAATCGGGAAGTTCCCCAA -> AAATCGGGAAGTTCCCCAAC
AAACAACGGTCCAAGCAAGA -> AACAACGGTCCAAGCAAGAT
AAACAACTGTATTTCGGCCT -> AACAACTGTATTTCGGCCTC
AAACACATGGGGTGGTTAAC -> AACACATGGGGTGGTTAACA
AAACGTTGTTGTTTTTCGGC -> AACGTTGTTGTTTTTCGGCC
AAAGCCTTCCTCCGTTATTG -> AAGCCTTCCTCCGTTATTGT
AAAGCGCGTGTCCACCTAGT -> AAGCGCGTGTCCACCTAGTT
AAAGGCCCCACACCAATGTG -> AAGGCCCCACACCAATGTGG
AAAGGTCGTCACAAATGACC -> AAGGTCGTCACAAATGACCA
AAAGTCAACTGGTGTGAGGC -> AAGTCAACTGGTGTGAGGCT
AAATCGGGAAGTTCCCCAAC -> AATCGGGAAGTTCCCCAACC
AAATCGGGCGGTGGGTACCT -> AATCGGGCGGTGGGTACCTT
AAATGACCAAGGTACTATCG -> AATGACCAAGGTACTATCGT
AAATTATGAAGGCGCCTTAA -> AATTATGAAGGCGCCTTAAT
AAATTTCTCTGGTTAAAGGT -> AATTTCTCTGGTTAAAGGTC
AACAAATTATGAAGGCGCCT -> ACAAATTATGAAGGCGCCTT
AACAACGGTCCAAGCAAGAT -> ACAACGGTCCAAGCAAGATC
AACAACTGTATTTCGGCCTC -> ACAACTGTATTTCGGCCTCG
AACAATTCAGAATAACCAGT -> ACAATTCAGAATAACCAGTC
AACACATGGGGTGGTTAACA -> ACACATGGGGTGGTTAACAT
AACAGCGTCACCTAAGAAAA -> ACAGCGTCACCTAAGAAAAG
AACAGCTTGTATAGTATTAC -> ACAGCTTGTATAGTATTACA
AACATACGTGTGGATCTGAC -> ACATACGTGTGGATCTGACT
AACCCCCTCCTAAAGCCTTC -> ACCCCCTCCTAAAGCCTTCC
AACCGAAGATATAGTATTGG -> ACCGAAGATATAGTATTGGC
AACGGGCTATCACTGCCCAA -> ACGGGCTATCACTGCCCAAG
AACGGTCCAAGCAAGATCGT -> ACGGTCCAAGCAAGATCGTC
AACGTTGTTGTTTTTCGGCC -> ACGTTGTTGTTTTTCGGCCT
AACTGGTGTGAGGCTCCGTA -> ACTGGTGTGAGGCTCCGTAT
AACTGTATTTCGGCCTCGCG -> ACTGTATTTCGGCCTCGCGT
AAGAAAAGGCCCCACACCAA -> AGAAAAGGCCCCACACCAAT
AAGAGATGAGCCCCGAATCT -> AGAGATGAGCCCCGAATCTG
AAGATATAGTATTGGCTCAA -> AGATATAGTATTGGCTCAAT
AAGATCGTACGCATTGGCCA -> AGATCGTACGCATTGGCCAA
AAGATCGTCGTTTCATCTCC -> AGATCGTCGTTTCATCTCCC
AAGCAAGATCGTCGTTTCAT -> AGCAAGATCGTCGTTTCATC
AAGCCTTCCTCCGTTATTGT -> AGCCTTCCTCCGTTATTGTT
AAGCGCGTGTCCACCTAGTT -> AGCGCGTGTCCACCTAGTTT
AAGGCCCCACACCAATGTGG -> AGGCCCCACACCAATGTGGT
AAGGCGCCTTAATCGGATCA -> AGGCGCCTTAATCGGATCAG
AAGGTACTATCGTAGCAAGT -> AGGTACTATCGTAGCAAGTT
AAGGTCGTCACAAATGACCA -> AGGTCGTCACAAATGACCAA
AAGTCAACTGGTGTGAGGCT -> AGTCAACTGGTGTGAGGCTC
AAGTTCCCCAACCCCCTCCT -> AGTTCCCCAACCCCCTCCTA
AAGTTGGTCTGGAGGATACT -> AGTTGGTCTGGAGGATACTC
AATAGACAAACACATGGGGT -> ATAGACAAACACATGGGGTG
AATATTTATCAGGCGACCAC -> ATATTTATCAGGCGACCACT
AATCGGATCAGAGCCCGGCA -> ATCGGATCAGAGCCCGGCAA
AATCGGGAAGTTCCCCAACC -> ATCGGGAAGTTCCCCAACCC
AATCGGGCGGTGGGTACCTT -> ATCGGGCGGTGGGTACCTTT
AATCTGCTTGCAATTCGGAG -> ATCTGCTTGCAATTCGGAGT
AATGACCAAGGTACTATCGT -> ATGACCAAGGTACTATCGTA
AATGAGGGTAGTTGGACGCC -> ATGAGGGTAGTTGGACGCCG
AATGTGGTATTTTGGAGGCG -> ATGTGGTATTTTGGAGGCGT
AATTAGCGTAGCTGGCCCAG -> ATTAGCGTAGCTGGCCCAGG
AATTATGAAGGCGCCTTAAT -> ATTATGAAGGCGCCTTAATC
AATTCAGAATAACCAGTCCG -> ATTCAGAATAACCAGTCCGT
AATTCCAAAGCGCGTGTCCA -> ATTCCAAAGCGCGTGTCCAC
AATTCGGAGTCACTGCAATT -> ATTCGGAGTCACTGCAATTT
AATTGCCTTATCCACACTAT -> ATTGCCTTATCCACACTATG
AATTTCTAGAACAATTCAGA -> ATTTCTAGAACAATTCAGAA
AATTTCTCTGGTTAAAGGTC -> ATTTCTCTGGTTAAAGGTCG
ACAAACACATGGGGTGGTTA -> CAAACACATGGGGTGGTTAA
ACAAATGACCAAGGTACTAT -> CAAATGACCAAGGTACTATC
ACAAATTATGAAGGCGCCTT -> CAAATTATGAAGGCGCCTTA
ACAACGGTCCAAGCAAGATC -> CAACGGTCCAAGCAAGATCG
ACAACTGTATTTCGGCCTCG -> CAACTGTATTTCGGCCTCGC
ACAATTCAGAATAACCAGTC -> CAATTCAGAATAACCAGTCC
ACACATGGGGTGGTTAACAT -> CACATGGGGTGGTTAACATA
ACACCAATGTGGTATTTTGG -> CACCAATGTGGTATTTTGGA
ACACTATGGCATCCGCGAGT -> CACTATGGCATCCGCGAGTG
ACAGCGTCACCTAAGAAAAG -> CAGCGTCACCTAAGAAAAGG
ACAGCTTGTATAGTATTACA -> CAGCTTGTATAGTATTACAT
ACAGTCCGTTTACTGGGTGC -> CAGTCCGTTTACTGGGTGCG
ACATACGTGTGGATCTGACT -> CATACGTGTGGATCTGACTG
ACATCACCCAGCTAAGAGAT -> CATCACCCAGCTAAGAGATG
ACATCCGGCGCTTCATTCTC -> CATCCGGCGCTTCATTCTCG
ACATGGGGTGGTTAACATAC -> CATGGGGTGGTTAACATACG
ACCAAGGTACTATCGTAGCA -> CCAAGGTACTATCGTAGCAA
ACCAATGTGGTATTTTGGAG -> CCAATGTGGTATTTTGGAGG
ACCACTATAAAGTCAACTGG -> CCACTATAAAGTCAACTGGT
ACCATCGTCATCCACGAACC -> CCATCGTCATCCACGAACCG
ACCCAGCTAAGAGATGAGCC -> CCCAGCTAAGAGATGAGCCC
ACCCCCTCCTAAAGCCTTCC -> CCCCCTCCTAAAGCCTTCCT
ACCCTAGCACGCTGATGTGG -> CCCTAGCACGCTGATGTGGA
ACCGAAGATATAGTATTGGC -> CCGAAGATATAGTATTGGCT
ACCTAAGAAAAGGCCCCACA -> CCTAAGAAAAGGCCCCACAC
ACCTAGTTTTCTTAGCGAGC -> CCTAGTTTTCTTAGCGAGCT
ACCTTTTAGCAGGGCTTGCG -> CCTTTTAGCAGGGCTTGCGG
ACGAACCGAAGATATAGTAT -> CGAACCGAAGATATAGTATT
ACGATGTATTCACGTCCTTG -> CGATGTATTCACGTCCTTGT
ACGATTACGATGTATTCACG -> CGATTACGATGTATTCACGT
ACGCATTGGCCAAAATCGGG -> CGCATTGGCCAAAATCGGGA
ACGCCGTTTCGCCCGCTAGC -> CGCCGTTTCGCCCGCTAGCG
ACGCTAACAGCTTGTATAGT -> CGCTAACAGCTTGTATAGTA
ACGCTGATGTGGACGCTAAC -> CGCTGATGTGGACGCTAACA
ACGGGCTATCACTGCCCAAG -> CGGGCTATCACTGCCCAAGA
ACGGTCCAAGCAAGATCGTC -> CGGTCCAAGCAAGATCGTCG
ACGTCCTTGTAACAAATTAT -> CGTCCTTGTAACAAATTATG
ACGTGTGGATCTGACTGCCA -> CGTGTGGATCTGACTGCCAA
ACGTTGTTGTTTTTCGGCCT -> CGTTGTTGTTTTTCGGCCTT
ACTATAAAGTCAACTGGTGT -> CTATAAAGTCAACTGGTGTG
ACTATCGTAGCAAGTTGGTC -> CTATCGTAGCAAGTTGGTCT
ACTATCTCGCCCCAATATTT -> CTATCTCGCCCCAATATTTA
ACTATGGCATCCGCGAGTGG -> CTATGGCATCCGCGAGTGGG
ACTCACTATCTCGCCCCAAT -> CTCACTATCTCGCCCCAATA
ACTGCAATTTCTAGAACAAT -> CTGCAATTTCTAGAACAATT
ACTGCCAAACAACTGTATTT -> CTGCCAAACAACTGTATTTC
ACTGCCCAAGATCGTACGCA -> CTGCCCAAGATCGTACGCAT
ACTGGGTGCGTGGGCTTCGC -> CTGGGTGCGTGGGCTTCGCA
ACTGGTGTGAGGCTCCGTAT -> CTGGTGTGAGGCTCCGTATA
ACTGTATTTCGGCCTCGCGT -> CTGTATTTCGGCCTCGCGTC
AGAAAAGGCCCCACACCAAT -> GAAAAGGCCCCACACCAATG
AGAACAATTCAGAATAACCA -> GAACAATTCAGAATAACCAG
AGACAAACACATGGGGTGGT -> GACAAACACATGGGGTGGTT
AGACAGTCCGTTTACTGGGT -> GACAGTCCGTTTACTGGGTG
AGACCATCGTCATCCACGAA -> GACCATCGTCATCCACGAAC
AGAGAGGTTTGGGGGAAACG -> GAGAGGTTTGGGGGAAACGT
AGAGATGAGCCCCGAATCTG -> GAGATGAGCCCCGAATCTGC
AGAGCCCGGCAATTCCAAAG -> GAGCCCGGCAATTCCAAAGC
AGAGGTTTGGGGGAAACGTT -> GAGGTTTGGGGGAAACGTTG
AGATATAGTATTGGCTCAAT -> GATATAGTATTGGCTCAATA
AGATCGTACGCATTGGCCAA -> GATCGTACGCATTGGCCAAA
AGATCGTCGTTTCATCTCCC -> GATCGTCGTTTCATCTCCCA
AGATGAGCCCCGAATCTGCT -> GATGAGCCCCGAATCTGCTT
AGCAAGATCGTCGTTTCATC -> GCAAGATCGTCGTTTCATCT
AGCAAGTTGGTCTGGAGGAT -> GCAAGTTGGTCTGGAGGATA
AGCACGCTGATGTGGACGCT -> GCACGCTGATGTGGACGCTA
AGCAGGGCTTGCGGAGCTTG -> GCAGGGCTTGCGGAGCTTGT
AGCCCCGAATCTGCTTGCAA -> GCCCCGAATCTGCTTGCAAT
AGCCCGGCAATTCCAAAGCG -> GCCCGGCAATTCCAAAGCGC
AGCCTTCCTCCGTTATTGTT -> GCCTTCCTCCGTTATTGTTT
AGCGAGCTAAATTTCTCTGG -> GCGAGCTAAATTTCTCTGGT
AGCGCGTGTCCACCTAGTTT -> GCGCGTGTCCACCTAGTTTT
AGCGGAAATCGGGCGGTGGG -> GCGGAAATCGGGCGGTGGGT
AGCGTAGCTGGCCCAGGCGA -> GCGTAGCTGGCCCAGGCGAA
AGCGTCACCTAAGAAAAGGC -> GCGTCACCTAAGAAAAGGCC
AGCTAAATTTCTCTGGTTAA -> GCTAAATTTCTCTGGTTAAA
AGCTAAGAGATGAGCCCCGA -> GCTAAGAGATGAGCCCCGAA
AGCTGGCCCAGGCGAATTGC -> GCTGGCCCAGGCGAATTGCC
AGCTTGTATAGTATTACATC -> GCTTGTATAGTATTACATCC
AGCTTGTGTAGACCATCGTC -> GCTTGTGTAGACCATCGTCA
AGGATACTCACTATCTCGCC -> GGATACTCACTATCTCGCCC
AGGCCCCACACCAATGTGGT -> GGCCCCACACCAATGTGGTA
AGGCGAATTGCCTTATCCAC -> GGCGAATTGCCTTATCCACA
AGGCGACCACTATAAAGTCA -> GGCGACCACTATAAAGTCAA
AGGCGCCTTAATCGGATCAG -> GGCGCCTTAATCGGATCAGA
AGGCGTGTAGACAGTCCGTT -> GGCGTGTAGACAGTCCGTTT
AGGCTCCGTATAGGTTCCGG -> GGCTCCGTATAGGTTCCGGG
AGGGCTTGCGGAGCTTGTGT -> GGGCTTGCGGAGCTTGTGTA
AGGGTAGTTGGACGCCGTTT -> GGGTAGTTGGACGCCGTTTC
AGGGTCCGAATGAGGGTAGT -> GGGTCCGAATGAGGGTAGTT
AGGTACTATCGTAGCAAGTT -> GGTACTATCGTAGCAAGTTG
AGGTCGTCACAAATGACCAA -> GGTCGTCACAAATGACCAAG
AGGTTCCGGGTGTATTTTGC -> GGTTCCGGGTGTATTTTGCA
AGGTTGTGCCGATTAGAGAG -> GGTTGTGCCGATTAGAGAGG
AGGTTTGGGGGAAACGTTGT -> GGTTTGGGGGAAACGTTGTT
AGTATTACATCCGGCGCTTC -> GTATTACATCCGGCGCTTCA
AGTATTGGCTCAATAGACAA -> GTATTGGCTCAATAGACAAA
AGTCAACTGGTGTGAGGCTC -> GTCAACTGGTGTGAGGCTCC
AGTCACTGCAATTTCTAGAA -> GTCACTGCAATTTCTAGAAC
AGTCCGTTTACTGGGTGCGT -> GTCCGTTTACTGGGTGCGTG
AGTGGGGTTCGGAAACAACG -> GTGGGGTTCGGAAACAACGG
AGTTCCCCAACCCCCTCCTA -> GTTCCCCAACCCCCTCCTAA
AGTTGGACGCCGTTTCGCCC -> GTTGGACGCCGTTTCGCCCG
AGTTGGTCTGGAGGATACTC -> GTTGGTCTGGAGGATACTCA
AGTTTTCTTAGCGAGCTAAA -> GTTTTCTTAGCGAGCTAAAT
ATAAAGTCAACTGGTGTGAG -> TAAAGTCAACTGGTGTGAGG
ATACGATTACGATGTATTCA -> TACGATTACGATGTATTCAC
ATACGTGTGGATCTGACTGC -> TACGTGTGGATCTGACTGCC
ATACTCACTATCTCGCCCCA -> TACTCACTATCTCGCCCCAA
ATAGACAAACACATGGGGTG -> TAGACAAACACATGGGGTGG
ATAGGTTCCGGGTGTATTTT -> TAGGTTCCGGGTGTATTTTG
ATAGTATTACATCCGGCGCT -> TAGTATTACATCCGGCGCTT
ATAGTATTGGCTCAATAGAC -> TAGTATTGGCTCAATAGACA
ATATAGTATTGGCTCAATAG -> TATAGTATTGGCTCAATAGA
ATATTTATCAGGCGACCACT -> TATTTATCAGGCGACCACTA
ATCACCCAGCTAAGAGATGA -> TCACCCAGCTAAGAGATGAG
ATCACTGCCCAAGATCGTAC -> TCACTGCCCAAGATCGTACG
ATCAGAGCCCGGCAATTCCA -> TCAGAGCCCGGCAATTCCAA
ATCAGGCGACCACTATAAAG -> TCAGGCGACCACTATAAAGT
ATCCACACTATGGCATCCGC -> TCCACACTATGGCATCCGCG
ATCCACGAACCGAAGATATA -> TCCACGAACCGAAGATATAG
ATCCGCGAGTGGGGTTCGGA -> TCCGCGAGTGGGGTTCGGAA
ATCCGGCGCTTCATTCTCGT -> TCCGGCGCTTCATTCTCGTA
ATCGCCATCTTGCATTAGGT -> TCGCCATCTTGCATTAGGTT
ATCGGATCAGAGCCCGGCAA -> TCGGATCAGAGCCCGGCAAT
ATCGGGAAGTTCCCCAACCC -> TCGGGAAGTTCCCCAACCCC
ATCGGGCGGTGGGTACCTTT -> TCGGGCGGTGGGTACCTTTT
ATCGTACGCATTGGCCAAAA -> TCGTACGCATTGGCCAAAAT
ATCGTAGCAAGTTGGTCTGG -> TCGTAGCAAGTTGGTCTGGA
ATCGTCATCCACGAACCGAA -> TCGTCATCCACGAACCGAAG
ATCGTCGTTTCATCTCCCAT -> TCGTCGTTTCATCTCCCATT
ATCTCCCATTTAACAGCGTC -> TCTCCCATTTAACAGCGTCA
ATCTCGCCCCAATATTTATC -> TCTCGCCCCAATATTTATCA
ATCTGACTGCCAAACAACTG -> TCTGACTGCCAAACAACTGT
ATCTGCTTGCAATTCGGAGT -> TCTGCTTGCAATTCGGAGTC
ATCTTGCATTAGGTTGTGCC -> TCTTGCATTAGGTTGTGCCG
ATGAAGGCGCCTTAATCGGA -> TGAAGGCGCCTTAATCGGAT
ATGACATCACCCAGCTAAGA -> TGACATCACCCAGCTAAGAG
ATGACCAAGGTACTATCGTA -> TGACCAAGGTACTATCGTAG
ATGAGCCCCGAATCTGCTTG -> TGAGCCCCGAATCTGCTTGC
ATGAGGGTAGTTGGACGCCG -> TGAGGGTAGTTGGACGCCGT
ATGGCATCCGCGAGTGGGGT -> TGGCATCCGCGAGTGGGGTT
ATGGGGTGGTTAACATACGT -> TGGGGTGGTTAACATACGTG
ATGTATTCACGTCCTTGTAA -> TGTATTCACGTCCTTGTAAC
ATGTGGACGCTAACAGCTTG -> TGTGGACGCTAACAGCTTGT
ATGTGGTATTTTGGAGGCGT -> TGTGGTATTTTGGAGGCGTG
ATTACATCCGGCGCTTCATT -> TTACATCCGGCGCTTCATTC
ATTACGATGTATTCACGTCC -> TTACGATGTATTCACGTCCT
ATTAGAGAGGTTTGGGGGAA -> TTAGAGAGGTTTGGGGGAAA
ATTAGCGTAGCTGGCCCAGG -> TTAGCGTAGCTGGCCCAGGC
ATTAGGTTGTGCCGATTAGA -> TTAGGTTGTGCCGATTAGAG
ATTATGAAGGCGCCTTAATC -> TTATGAAGGCGCCTTAATCG
ATTCACGTCCTTGTAACAAA -> TTCACGTCCTTGTAACAAAT
ATTCAGAATAACCAGTCCGT -> TTCAGAATAACCAGTCCGTC
ATTCCAAAGCGCGTGTCCAC -> TTCCAAAGCGCGTGTCCACC
ATTCGGAGTCACTGCAATTT -> TTCGGAGTCACTGCAATTTC
ATTCTCGTATGACATCACCC -> TTCTCGTATGACATCACCCA
ATTGCCTTATCCACACTATG -> TTGCCTTATCCACACTATGG
ATTGGCCAAAATCGGGAAGT -> TTGGCCAAAATCGGGAAGTT
ATTGGCTCAATAGACAAACA -> TTGGCTCAATAGACAAACAC
ATTGTTTATACGATTACGAT -> TTGTTTATACGATTACGATG
ATTTAACAGCGTCACCTAAG -> TTTAACAGCGTCACCTAAGA
ATTTATCAGGCGACCACTAT -> TTTATCAGGCGACCACTATA
ATTTCGGCCTCGCGTCGGCA -> TTTCGGCCTCGCGTCGGCAA
ATTTCTAGAACAATTCAGAA -> TTTCTAGAACAATTCAGAAT
ATTTCTCTGGTTAAAGGTCG -> TTTCTCTGGTTAAAGGTCGT
ATTTTGCATCGCCATCTTGC -> TTTTGCATCGCCATCTTGCA
ATTTTGGAGGCGTGTAGACA -> TTTTGGAGGCGTGTAGACAG
CAAAATCGGGAAGTTCCCCA -> AAAATCGGGAAGTTCCCCAA
CAAACAACTGTATTTCGGCC -> AAACAACTGTATTTCGGCCT
CAAACACATGGGGTGGTTAA -> AAACACATGGGGTGGTTAAC
CAAAGCGCGTGTCCACCTAG -> AAAGCGCGTGTCCACCTAGT
CAAATGACCAAGGTACTATC -> AAATGACCAAGGTACTATCG
CAAATTATGAAGGCGCCTTA -> AAATTATGAAGGCGCCTTAA
CAACCCCCTCCTAAAGCCTT -> AACCCCCTCCTAAAGCCTTC
CAACGGGCTATCACTGCCCA -> AACGGGCTATCACTGCCCAA
CAACGGTCCAAGCAAGATCG -> AACGGTCCAAGCAAGATCGT
CAACTGGTGTGAGGCTCCGT -> AACTGGTGTGAGGCTCCGTA
CAACTGTATTTCGGCCTCGC -> AACTGTATTTCGGCCTCGCG
CAAGATCGTACGCATTGGCC -> AAGATCGTACGCATTGGCCA
CAAGATCGTCGTTTCATCTC -> AAGATCGTCGTTTCATCTCC
CAAGCAAGATCGTCGTTTCA -> AAGCAAGATCGTCGTTTCAT
CAAGGTACTATCGTAGCAAG -> AAGGTACTATCGTAGCAAGT
CAAGTTGGTCTGGAGGATAC -> AAGTTGGTCTGGAGGATACT
CAATAGACAAACACATGGGG -> AATAGACAAACACATGGGGT
CAATATTTATCAGGCGACCA -> AATATTTATCAGGCGACCAC
CAATGTGGTATTTTGGAGGC -> AATGTGGTATTTTGGAGGCG
CAATTAGCGTAGCTGGCCCA -> AATTAGCGTAGCTGGCCCAG
CAATTCAGAATAACCAGTCC -> AATTCAGAATAACCAGTCCG
CAATTCCAAAGCGCGTGTCC -> AATTCCAAAGCGCGTGTCCA
CAATTCGGAGTCACTGCAAT -> AATTCGGAGTCACTGCAATT
CAATTTCTAGAACAATTCAG -> AATTTCTAGAACAATTCAGA
CACAAATGACCAAGGTACTA -> ACAAATGACCAAGGTACTAT
CACACCAATGTGGTATTTTG -> ACACCAATGTGGTATTTTGG
CACACTATGGCATCCGCGAG -> ACACTATGGCATCCGCGAGT
CACATGGGGTGGTTAACATA -> ACATGGGGTGGTTAACATAC
CACCAATGTGGTATTTTGGA -> ACCAATGTGGTATTTTGGAG
CACCCAGCTAAGAGATGAGC -> ACCCAGCTAAGAGATGAGCC
CACCCTAGCACGCTGATGTG -> ACCCTAGCACGCTGATGTGG
CACCTAAGAAAAGGCCCCAC -> ACCTAAGAAAAGGCCCCACA
CACCTAGTTTTCTTAGCGAG -> ACCTAGTTTTCTTAGCGAGC
CACGAACCGAAGATATAGTA -> ACGAACCGAAGATATAGTAT
CACGCTGATGTGGACGCTAA -> ACGCTGATGTGGACGCTAAC
CACGTCCTTGTAACAAATTA -> ACGTCCTTGTAACAAATTAT
CACTATAAAGTCAACTGGTG -> ACTATAAAGTCAACTGGTGT
CACTATCTCGCCCCAATATT -> ACTATCTCGCCCCAATATTT
CACTATGGCATCCGCGAGTG -> ACTATGGCATCCGCGAGTGG
CACTGCAATTTCTAGAACAA -> ACTGCAATTTCTAGAACAAT
CACTGCCCAAGATCGTACGC -> ACTGCCCAAGATCGTACGCA
CAGAGCCCGGCAATTCCAAA -> AGAGCCCGGCAATTCCAAAG
CAGCGTCACCTAAGAAAAGG -> AGCGTCACCTAAGAAAAGGC
CAGCTAAGAGATGAGCCCCG -> AGCTAAGAGATGAGCCCCGA
CAGCTTGTATAGTATTACAT -> AGCTTGTATAGTATTACATC
CAGGCGAATTGCCTTATCCA -> AGGCGAATTGCCTTATCCAC
CAGGCGACCACTATAAAGTC -> AGGCGACCACTATAAAGTCA
CAGGGCTTGCGGAGCTTGTG -> AGGGCTTGCGGAGCTTGTGT
CAGTCCGTTTACTGGGTGCG -> AGTCCGTTTACTGGGTGCGT
CATACGTGTGGATCTGACTG -> ATACGTGTGGATCTGACTGC
CATCACCCAGCTAAGAGATG -> ATCACCCAGCTAAGAGATGA
CATCCACGAACCGAAGATAT -> ATCCACGAACCGAAGATATA
CATCCGCGAGTGGGGTTCGG -> ATCCGCGAGTGGGGTTCGGA
CATCCGGCGCTTCATTCTCG -> ATCCGGCGCTTCATTCTCGT
CATCGCCATCTTGCATTAGG -> ATCGCCATCTTGCATTAGGT
CATCGTCATCCACGAACCGA -> ATCGTCATCCACGAACCGAA
CATCTCCCATTTAACAGCGT -> ATCTCCCATTTAACAGCGTC
CATCTTGCATTAGGTTGTGC -> ATCTTGCATTAGGTTGTGCC
CATGGGGTGGTTAACATACG -> ATGGGGTGGTTAACATACGT
CATTAGGTTGTGCCGATTAG -> ATTAGGTTGTGCCGATTAGA
CATTCTCGTATGACATCACC -> ATTCTCGTATGACATCACCC
CATTGGCCAAAATCGGGAAG -> ATTGGCCAAAATCGGGAAGT
CATTTAACAGCGTCACCTAA -> ATTTAACAGCGTCACCTAAG
CCAAAATCGGGAAGTTCCCC -> CAAAATCGGGAAGTTCCCCA
CCAAACAACTGTATTTCGGC -> CAAACAACTGTATTTCGGCC
CCAAAGCGCGTGTCCACCTA -> CAAAGCGCGTGTCCACCTAG
CCAACCCCCTCCTAAAGCCT -> CAACCCCCTCCTAAAGCCTT
CCAAGATCGTACGCATTGGC -> CAAGATCGTACGCATTGGCC
CCAAGCAAGATCGTCGTTTC -> CAAGCAAGATCGTCGTTTCA
CCAAGGTACTATCGTAGCAA -> CAAGGTACTATCGTAGCAAG
CCAATATTTATCAGGCGACC -> CAATATTTATCAGGCGACCA
CCAATGTGGTATTTTGGAGG -> CAATGTGGTATTTTGGAGGC
CCACACCAATGTGGTATTTT -> CACACCAATGTGGTATTTTG
CCACACTATGGCATCCGCGA -> CACACTATGGCATCCGCGAG
CCACCTAGTTTTCTTAGCGA -> CACCTAGTTTTCTTAGCGAG
CCACGAACCGAAGATATAGT -> CACGAACCGAAGATATAGTA
CCACTATAAAGTCAACTGGT -> CACTATAAAGTCAACTGGTG
CCAGCTAAGAGATGAGCCCC -> CAGCTAAGAGATGAGCCCCG
CCAGGCGAATTGCCTTATCC -> CAGGCGAATTGCCTTATCCA
CCATCGTCATCCACGAACCG -> CATCGTCATCCACGAACCGA
CCATCTTGCATTAGGTTGTG -> CATCTTGCATTAGGTTGTGC
CCATTTAACAGCGTCACCTA -> CATTTAACAGCGTCACCTAA
CCCAACCCCCTCCTAAAGCC -> CCAACCCCCTCCTAAAGCCT
CCCAAGATCGTACGCATTGG -> CCAAGATCGTACGCATTGGC
CCCAATATTTATCAGGCGAC -> CCAATATTTATCAGGCGACC
CCCACACCAATGTGGTATTT -> CCACACCAATGTGGTATTTT
CCCAGCTAAGAGATGAGCCC -> CCAGCTAAGAGATGAGCCCC
CCCAGGCGAATTGCCTTATC -> CCAGGCGAATTGCCTTATCC
CCCATTTAACAGCGTCACCT -> CCATTTAACAGCGTCACCTA
CCCCAACCCCCTCCTAAAGC -> CCCAACCCCCTCCTAAAGCC
CCCCAATATTTATCAGGCGA -> CCCAATATTTATCAGGCGAC
CCCCACACCAATGTGGTATT -> CCCACACCAATGTGGTATTT
CCCCCTCCTAAAGCCTTCCT -> CCCCTCCTAAAGCCTTCCTC
CCCCGAATCTGCTTGCAATT -> CCCGAATCTGCTTGCAATTC
CCCCTCCTAAAGCCTTCCTC -> CCCTCCTAAAGCCTTCCTCC
CCCGAATCTGCTTGCAATTC -> CCGAATCTGCTTGCAATTCG
CCCGCTAGCGGAAATCGGGC -> CCGCTAGCGGAAATCGGGCG
CCCGGCAATTCCAAAGCGCG -> CCGGCAATTCCAAAGCGCGT
CCCTAGCACGCTGATGTGGA -> CCTAGCACGCTGATGTGGAC
CCCTCCTAAAGCCTTCCTCC -> CCTCCTAAAGCCTTCCTCCG
CCGAAGATATAGTATTGGCT -> CGAAGATATAGTATTGGCTC
CCGAATCTGCTTGCAATTCG -> CGAATCTGCTTGCAATTCGG
CCGAATGAGGGTAGTTGGAC -> CGAATGAGGGTAGTTGGACG
CCGATTAGAGAGGTTTGGGG -> CGATTAGAGAGGTTTGGGGG
CCGCGAGTGGGGTTCGGAAA -> CGCGAGTGGGGTTCGGAAAC
CCGCTAGCGGAAATCGGGCG -> CGCTAGCGGAAATCGGGCGG
CCGGCAATTCCAAAGCGCGT -> CGGCAATTCCAAAGCGCGTG
CCGGCGCTTCATTCTCGTAT -> CGGCGCTTCATTCTCGTATG
CCGGGTGTATTTTGCATCGC -> CGGGTGTATTTTGCATCGCC
CCGTATAGGTTCCGGGTGTA -> CGTATAGGTTCCGGGTGTAT
CCGTTATTGTTTATACGATT -> CGTTATTGTTTATACGATTA
CCGTTTACTGGGTGCGTGGG -> CGTTTACTGGGTGCGTGGGC
CCGTTTCGCCCGCTAGCGGA -> CGTTTCGCCCGCTAGCGGAA
CCTAAAGCCTTCCTCCGTTA -> CTAAAGCCTTCCTCCGTTAT
CCTAAGAAAAGGCCCCACAC -> CTAAGAAAAGGCCCCACACC
CCTAGCACGCTGATGTGGAC -> CTAGCACGCTGATGTGGACG
CCTAGTTTTCTTAGCGAGCT -> CTAGTTTTCTTAGCGAGCTA
CCTCCGTTATTGTTTATACG -> CTCCGTTATTGTTTATACGA
CCTCCTAAAGCCTTCCTCCG -> CTCCTAAAGCCTTCCTCCGT
CCTCGCGTCGGCAATTAGCG -> CTCGCGTCGGCAATTAGCGT
CCTTAATCGGATCAGAGCCC -> CTTAATCGGATCAGAGCCCG
CCTTATCCACACTATGGCAT -> CTTATCCACACTATGGCATC
CCTTCCTCCGTTATTGTTTA -> CTTCCTCCGTTATTGTTTAT
CCTTCTAGGGTCCGAATGAG -> CTTCTAGGGTCCGAATGAGG
CCTTGTAACAAATTATGAAG -> CTTGTAACAAATTATGAAGG
CCTTTTAGCAGGGCTTGCGG -> CTTTTAGCAGGGCTTGCGGA
CGAACCGAAGATATAGTATT -> GAACCGAAGATATAGTATTG
CGAAGATATAGTATTGGCTC -> GAAGATATAGTATTGGCTCA
CGAATCTGCTTGCAATTCGG -> GAATCTGCTTGCAATTCGGA
CGAATGAGGGTAGTTGGACG -> GAATGAGGGTAGTTGGACGC
CGAATTGCCTTATCCACACT -> GAATTGCCTTATCCACACTA
CGACCACTATAAAGTCAACT -> GACCACTATAAAGTCAACTG
CGAGCTAAATTTCTCTGGTT -> GAGCTAAATTTCTCTGGTTA
CGAGTGGGGTTCGGAAACAA -> GAGTGGGGTTCGGAAACAAC
CGATGTATTCACGTCCTTGT -> GATGTATTCACGTCCTTGTA
CGATTACGATGTATTCACGT -> GATTACGATGTATTCACGTC
CGATTAGAGAGGTTTGGGGG -> GATTAGAGAGGTTTGGGGGA
CGCACCCTAGCACGCTGATG -> GCACCCTAGCACGCTGATGT
CGCATTGGCCAAAATCGGGA -> GCATTGGCCAAAATCGGGAA
CGCCATCTTGCATTAGGTTG -> GCCATCTTGCATTAGGTTGT
CGCCCCAATATTTATCAGGC -> GCCCCAATATTTATCAGGCG
CGCCCGCTAGCGGAAATCGG -> GCCCGCTAGCGGAAATCGGG
CGCCGTTTCGCCCGCTAGCG -> GCCGTTTCGCCCGCTAGCGG
CGCCTTAATCGGATCAGAGC -> GCCTTAATCGGATCAGAGCC
CGCGAGTGGGGTTCGGAAAC -> GCGAGTGGGGTTCGGAAACA
CGCGTCGGCAATTAGCGTAG -> GCGTCGGCAATTAGCGTAGC
CGCGTGTCCACCTAGTTTTC -> GCGTGTCCACCTAGTTTTCT
CGCTAACAGCTTGTATAGTA -> GCTAACAGCTTGTATAGTAT
CGCTAGCGGAAATCGGGCGG -> GCTAGCGGAAATCGGGCGGT
CGCTGATGTGGACGCTAACA -> GCTGATGTGGACGCTAACAG
CGCTTCATTCTCGTATGACA -> GCTTCATTCTCGTATGACAT
CGGAAACAACGGTCCAAGCA -> GGAAACAACGGTCCAAGCAA
CGGAAATCGGGCGGTGGGTA -> GGAAATCGGGCGGTGGGTAC
CGGAGCTTGTGTAGACCATC -> GGAGCTTGTGTAGACCATCG
CGGAGTCACTGCAATTTCTA -> GGAGTCACTGCAATTTCTAG
CGGATCAGAGCCCGGCAATT -> GGATCAGAGCCCGGCAATTC
CGGCAATTAGCGTAGCTGGC -> GGCAATTAGCGTAGCTGGCC
CGGCAATTCCAAAGCGCGTG -> GGCAATTCCAAAGCGCGTGT
CGGCCTCGCGTCGGCAATTA -> GGCCTCGCGTCGGCAATTAG
CGGCCTTCTAGGGTCCGAAT -> GGCCTTCTAGGGTCCGAATG
CGGCGCTTCATTCTCGTATG -> GGCGCTTCATTCTCGTATGA
CGGGAAGTTCCCCAACCCCC -> GGGAAGTTCCCCAACCCCCT
CGGGCGGTGGGTACCTTTTA -> GGGCGGTGGGTACCTTTTAG
CGGGCTATCACTGCCCAAGA -> GGGCTATCACTGCCCAAGAT
CGGGTGTATTTTGCATCGCC -> GGGTGTATTTTGCATCGCCA
CGGTCCAAGCAAGATCGTCG -> GGTCCAAGCAAGATCGTCGT
CGGTGGGTACCTTTTAGCAG -> GGTGGGTACCTTTTAGCAGG
CGTACGCATTGGCCAAAATC -> GTACGCATTGGCCAAAATCG
CGTAGCAAGTTGGTCTGGAG -> GTAGCAAGTTGGTCTGGAGG
CGTAGCTGGCCCAGGCGAAT -> GTAGCTGGCCCAGGCGAATT
CGTATAGGTTCCGGGTGTAT -> GTATAGGTTCCGGGTGTATT
CGTATGACATCACCCAGCTA -> GTATGACATCACCCAGCTAA
CGTCACAAATGACCAAGGTA -> GTCACAAATGACCAAGGTAC
CGTCACCTAAGAAAAGGCCC -> GTCACCTAAGAAAAGGCCCC
CGTCATCCACGAACCGAAGA -> GTCATCCACGAACCGAAGAT
CGTCCTTGTAACAAATTATG -> GTCCTTGTAACAAATTATGA
CGTCGGCAATTAGCGTAGCT -> GTCGGCAATTAGCGTAGCTG
CGTCGTTTCATCTCCCATTT -> GTCGTTTCATCTCCCATTTA
CGTGCAACGGGCTATCACTG -> GTGCAACGGGCTATCACTGC
CGTGGGCTTCGCACCCTAGC -> GTGGGCTTCGCACCCTAGCA
CGTGTAGACAGTCCGTTTAC -> GTGTAGACAGTCCGTTTACT
CGTGTCCACCTAGTTTTCTT -> GTGTCCACCTAGTTTTCTTA
CGTGTGGATCTGACTGCCAA -> GTGTGGATCTGACTGCCAAA
CGTTATTGTTTATACGATTA -> GTTATTGTTTATACGATTAC
CGTTGTTGTTTTTCGGCCTT -> GTTGTTGTTTTTCGGCCTTC
CGTTTACTGGGTGCGTGGGC -> GTTTACTGGGTGCGTGGGCT
CGTTTCATCTCCCATTTAAC -> GTTTCATCTCCCATTTAACA
CGTTTCGCCCGCTAGCGGAA -> GTTTCGCCCGCTAGCGGAAA
CTAAAGCCTTCCTCCGTTAT -> TAAAGCCTTCCTCCGTTATT
CTAAATTTCTCTGGTTAAAG -> TAAATTTCTCTGGTTAAAGG
CTAACAGCTTGTATAGTATT -> TAACAGCTTGTATAGTATTA
CTAAGAAAAGGCCCCACACC -> TAAGAAAAGGCCCCACACCA
CTAAGAGATGAGCCCCGAAT -> TAAGAGATGAGCCCCGAATC
CTAGAACAATTCAGAATAAC -> TAGAACAATTCAGAATAACC
CTAGCACGCTGATGTGGACG -> TAGCACGCTGATGTGGACGC
CTAGCGGAAATCGGGCGGTG -> TAGCGGAAATCGGGCGGTGG
CTAGGGTCCGAATGAGGGTA -> TAGGGTCCGAATGAGGGTAG
CTAGTTTTCTTAGCGAGCTA -> TAGTTTTCTTAGCGAGCTAA
CTATAAAGTCAACTGGTGTG -> TATAAAGTCAACTGGTGTGA
CTATCACTGCCCAAGATCGT -> TATCACTGCCCAAGATCGTA
CTATCGTAGCAAGTTGGTCT -> TATCGTAGCAAGTTGGTCTG
CTATCTCGCCCCAATATTTA -> TATCTCGCCCCAATATTTAT
CTATGGCATCCGCGAGTGGG -> TATGGCATCCGCGAGTGGGG
CTCAATAGACAAACACATGG -> TCAATAGACAAACACATGGG
CTCACTATCTCGCCCCAATA -> TCACTATCTCGCCCCAATAT
CTCCCATTTAACAGCGTCAC -> TCCCATTTAACAGCGTCACC
CTCCGTATAGGTTCCGGGTG -> TCCGTATAGGTTCCGGGTGT
CTCCGTTATTGTTTATACGA -> TCCGTTATTGTTTATACGAT
CTCCTAAAGCCTTCCTCCGT -> TCCTAAAGCCTTCCTCCGTT
CTCGCCCCAATATTTATCAG -> TCGCCCCAATATTTATCAGG
CTCGCGTCGGCAATTAGCGT -> TCGCGTCGGCAATTAGCGTA
CTCGTATGACATCACCCAGC -> TCGTATGACATCACCCAGCT
CTCTGGTTAAAGGTCGTCAC -> TCTGGTTAAAGGTCGTCACA
CTGACTGCCAAACAACTGTA -> TGACTGCCAAACAACTGTAT
CTGATGTGGACGCTAACAGC -> TGATGTGGACGCTAACAGCT
CTGCAATTTCTAGAACAATT -> TGCAATTTCTAGAACAATTC
CTGCCAAACAACTGTATTTC -> TGCCAAACAACTGTATTTCG
CTGCCCAAGATCGTACGCAT -> TGCCCAAGATCGTACGCATT
CTGCTTGCAATTCGGAGTCA -> TGCTTGCAATTCGGAGTCAC
CTGGAGGATACTCACTATCT -> TGGAGGATACTCACTATCTC
CTGGCCCAGGCGAATTGCCT -> TGGCCCAGGCGAATTGCCTT
CTGGCGTGCAACGGGCTATC -> TGGCGTGCAACGGGCTATCA
CTGGGTGCGTGGGCTTCGCA -> TGGGTGCGTGGGCTTCGCAC
CTGGTGTGAGGCTCCGTATA -> TGGTGTGAGGCTCCGTATAG
CTGGTTAAAGGTCGTCACAA -> TGGTTAAAGGTCGTCACAAA
CTGTATTTCGGCCTCGCGTC -> TGTATTTCGGCCTCGCGTCG
CTTAATCGGATCAGAGCCCG -> TTAATCGGATCAGAGCCCGG
CTTAGCGAGCTAAATTTCTC -> TTAGCGAGCTAAATTTCTCT
CTTATCCACACTATGGCATC -> TTATCCACACTATGGCATCC
CTTCATTCTCGTATGACATC -> TTCATTCTCGTATGACATCA
CTTCCTCCGTTATTGTTTAT -> TTCCTCCGTTATTGTTTATA
CTTCGCACCCTAGCACGCTG -> TTCGCACCCTAGCACGCTGA
CTTCTAGGGTCCGAATGAGG -> TTCTAGGGTCCGAATGAGGG
CTTGCAATTCGGAGTCACTG -> TTGCAATTCGGAGTCACTGC
CTTGCATTAGGTTGTGCCGA -> TTGCATTAGGTTGTGCCGAT
CTTGCGGAGCTTGTGTAGAC -> TTGCGGAGCTTGTGTAGACC
CTTGTAACAAATTATGAAGG -> TTGTAACAAATTATGAAGGC
CTTGTATAGTATTACATCCG -> TTGTATAGTATTACATCCGG
CTTGTGTAGACCATCGTCAT -> TTGTGTAGACCATCGTCATC
CTTTGTGTGCTGGCGTGCAA -> TTTGTGTGCTGGCGTGCAAC
CTTTTAGCAGGGCTTGCGGA -> TTTTAGCAGGGCTTGCGGAG
GAAAAGGCCCCACACCAATG -> AAAAGGCCCCACACCAATGT
GAAACAACGGTCCAAGCAAG -> AAACAACGGTCCAAGCAAGA
GAAACGTTGTTGTTTTTCGG -> AAACGTTGTTGTTTTTCGGC
GAAATCGGGCGGTGGGTACC -> AAATCGGGCGGTGGGTACCT
GAACAATTCAGAATAACCAG -> AACAATTCAGAATAACCAGT
GAACCGAAGATATAGTATTG -> AACCGAAGATATAGTATTGG
GAAGATATAGTATTGGCTCA -> AAGATATAGTATTGGCTCAA
GAAGGCGCCTTAATCGGATC -> AAGGCGCCTTAATCGGATCA
GAAGTTCCCCAACCCCCTCC -> AAGTTCCCCAACCCCCTCCT
GAATCTGCTTGCAATTCGGA -> AATCTGCTTGCAATTCGGAG
GAATGAGGGTAGTTGGACGC -> AATGAGGGTAGTTGGACGCC
GAATTGCCTTATCCACACTA -> AATTGCCTTATCCACACTAT
GACAAACACATGGGGTGGTT -> ACAAACACATGGGGTGGTTA
GACAGTCCGTTTACTGGGTG -> ACAGTCCGTTTACTGGGTGC
GACATCACCCAGCTAAGAGA -> ACATCACCCAGCTAAGAGAT
GACCAAGGTACTATCGTAGC -> ACCAAGGTACTATCGTAGCA
GACCACTATAAAGTCAACTG -> ACCACTATAAAGTCAACTGG
GACCATCGTCATCCACGAAC -> ACCATCGTCATCCACGAACC
GACGCCGTTTCGCCCGCTAG -> ACGCCGTTTCGCCCGCTAGC
GACGCTAACAGCTTGTATAG -> ACGCTAACAGCTTGTATAGT
GACTGCCAAACAACTGTATT -> ACTGCCAAACAACTGTATTT
GAGAGGTTTGGGGGAAACGT -> AGAGGTTTGGGGGAAACGTT
GAGATGAGCCCCGAATCTGC -> AGATGAGCCCCGAATCTGCT
GAGCCCCGAATCTGCTTGCA -> AGCCCCGAATCTGCTTGCAA
GAGCCCGGCAATTCCAAAGC -> AGCCCGGCAATTCCAAAGCG
GAGCTAAATTTCTCTGGTTA -> AGCTAAATTTCTCTGGTTAA
GAGCTTGTGTAGACCATCGT -> AGCTTGTGTAGACCATCGTC
GAGGATACTCACTATCTCGC -> AGGATACTCACTATCTCGCC
GAGGCGTGTAGACAGTCCGT -> AGGCGTGTAGACAGTCCGTT
GAGGCTCCGTATAGGTTCCG -> AGGCTCCGTATAGGTTCCGG
GAGGGTAGTTGGACGCCGTT -> AGGGTAGTTGGACGCCGTTT
GAGGTTTGGGGGAAACGTTG -> AGGTTTGGGGGAAACGTTGT
GAGTCACTGCAATTTCTAGA -> AGTCACTGCAATTTCTAGAA
GAGTGGGGTTCGGAAACAAC -> AGTGGGGTTCGGAAACAACG
GATACTCACTATCTCGCCCC -> ATACTCACTATCTCGCCCCA
GATATAGTATTGGCTCAATA -> ATATAGTATTGGCTCAATAG
GATCAGAGCCCGGCAATTCC -> ATCAGAGCCCGGCAATTCCA
GATCGTACGCATTGGCCAAA -> ATCGTACGCATTGGCCAAAA
GATCGTCGTTTCATCTCCCA -> ATCGTCGTTTCATCTCCCAT
GATCTGACTGCCAAACAACT -> ATCTGACTGCCAAACAACTG
GATGAGCCCCGAATCTGCTT -> ATGAGCCCCGAATCTGCTTG
GATGTATTCACGTCCTTGTA -> ATGTATTCACGTCCTTGTAA
GATGTGGACGCTAACAGCTT -> ATGTGGACGCTAACAGCTTG
GATTACGATGTATTCACGTC -> ATTACGATGTATTCACGTCC
GATTAGAGAGGTTTGGGGGA -> ATTAGAGAGGTTTGGGGGAA
GCAACGGGCTATCACTGCCC -> CAACGGGCTATCACTGCCCA
GCAAGATCGTCGTTTCATCT -> CAAGATCGTCGTTTCATCTC
GCAAGTTGGTCTGGAGGATA -> CAAGTTGGTCTGGAGGATAC
GCAATTAGCGTAGCTGGCCC -> CAATTAGCGTAGCTGGCCCA
GCAATTCCAAAGCGCGTGTC -> CAATTCCAAAGCGCGTGTCC
GCAATTCGGAGTCACTGCAA -> CAATTCGGAGTCACTGCAAT
GCAATTTCTAGAACAATTCA -> CAATTTCTAGAACAATTCAG
GCACCCTAGCACGCTGATGT -> CACCCTAGCACGCTGATGTG
GCACGCTGATGTGGACGCTA -> CACGCTGATGTGGACGCTAA
GCAGGGCTTGCGGAGCTTGT -> CAGGGCTTGCGGAGCTTGTG
GCATCCGCGAGTGGGGTTCG -> CATCCGCGAGTGGGGTTCGG
GCATCGCCATCTTGCATTAG -> CATCGCCATCTTGCATTAGG
GCATTAGGTTGTGCCGATTA -> CATTAGGTTGTGCCGATTAG
GCATTGGCCAAAATCGGGAA -> CATTGGCCAAAATCGGGAAG
GCCAAAATCGGGAAGTTCCC -> CCAAAATCGGGAAGTTCCCC
GCCAAACAACTGTATTTCGG -> CCAAACAACTGTATTTCGGC
GCCATCTTGCATTAGGTTGT -> CCATCTTGCATTAGGTTGTG
GCCCAAGATCGTACGCATTG -> CCCAAGATCGTACGCATTGG
GCCCAGGCGAATTGCCTTAT -> CCCAGGCGAATTGCCTTATC
GCCCCAATATTTATCAGGCG -> CCCCAATATTTATCAGGCGA
GCCCCACACCAATGTGGTAT -> CCCCACACCAATGTGGTATT
GCCCCGAATCTGCTTGCAAT -> CCCCGAATCTGCTTGCAATT
GCCCGCTAGCGGAAATCGGG -> CCCGCTAGCGGAAATCGGGC
GCCCGGCAATTCCAAAGCGC -> CCCGGCAATTCCAAAGCGCG
GCCGATTAGAGAGGTTTGGG -> CCGATTAGAGAGGTTTGGGG
GCCGTTTCGCCCGCTAGCGG -> CCGTTTCGCCCGCTAGCGGA
GCCTCGCGTCGGCAATTAGC -> CCTCGCGTCGGCAATTAGCG
GCCTTAATCGGATCAGAGCC -> CCTTAATCGGATCAGAGCCC
GCCTTATCCACACTATGGCA -> CCTTATCCACACTATGGCAT
GCCTTCCTCCGTTATTGTTT -> CCTTCCTCCGTTATTGTTTA
GCCTTCTAGGGTCCGAATGA -> CCTTCTAGGGTCCGAATGAG
GCGAATTGCCTTATCCACAC -> CGAATTGCCTTATCCACACT
GCGACCACTATAAAGTCAAC -> CGACCACTATAAAGTCAACT
GCGAGCTAAATTTCTCTGGT -> CGAGCTAAATTTCTCTGGTT
GCGAGTGGGGTTCGGAAACA -> CGAGTGGGGTTCGGAAACAA
GCGCCTTAATCGGATCAGAG -> CGCCTTAATCGGATCAGAGC
GCGCGTGTCCACCTAGTTTT -> CGCGTGTCCACCTAGTTTTC
GCGCTTCATTCTCGTATGAC -> CGCTTCATTCTCGTATGACA
GCGGAAATCGGGCGGTGGGT -> CGGAAATCGGGCGGTGGGTA
GCGGAGCTTGTGTAGACCAT -> CGGAGCTTGTGTAGACCATC
GCGGTGGGTACCTTTTAGCA -> CGGTGGGTACCTTTTAGCAG
GCGTAGCTGGCCCAGGCGAA -> CGTAGCTGGCCCAGGCGAAT
GCGTCACCTAAGAAAAGGCC -> CGTCACCTAAGAAAAGGCCC
GCGTCGGCAATTAGCGTAGC -> CGTCGGCAATTAGCGTAGCT
GCGTGCAACGGGCTATCACT -> CGTGCAACGGGCTATCACTG
GCGTGGGCTTCGCACCCTAG -> CGTGGGCTTCGCACCCTAGC
GCGTGTAGACAGTCCGTTTA -> CGTGTAGACAGTCCGTTTAC
GCGTGTCCACCTAGTTTTCT -> CGTGTCCACCTAGTTTTCTT
GCTAAATTTCTCTGGTTAAA -> CTAAATTTCTCTGGTTAAAG
GCTAACAGCTTGTATAGTAT -> CTAACAGCTTGTATAGTATT
GCTAAGAGATGAGCCCCGAA -> CTAAGAGATGAGCCCCGAAT
GCTAGCGGAAATCGGGCGGT -> CTAGCGGAAATCGGGCGGTG
GCTATCACTGCCCAAGATCG -> CTATCACTGCCCAAGATCGT
GCTCAATAGACAAACACATG -> CTCAATAGACAAACACATGG
GCTCCGTATAGGTTCCGGGT -> CTCCGTATAGGTTCCGGGTG
GCTGATGTGGACGCTAACAG -> CTGATGTGGACGCTAACAGC
GCTGGCCCAGGCGAATTGCC -> CTGGCCCAGGCGAATTGCCT
GCTGGCGTGCAACGGGCTAT -> CTGGCGTGCAACGGGCTATC
GCTTCATTCTCGTATGACAT -> CTTCATTCTCGTATGACATC
GCTTCGCACCCTAGCACGCT -> CTTCGCACCCTAGCACGCTG
GCTTGCAATTCGGAGTCACT -> CTTGCAATTCGGAGTCACTG
GCTTGCGGAGCTTGTGTAGA -> CTTGCGGAGCTTGTGTAGAC
GCTTGTATAGTATTACATCC -> CTTGTATAGTATTACATCCG
GCTTGTGTAGACCATCGTCA -> CTTGTGTAGACCATCGTCAT
GGAAACAACGGTCCAAGCAA -> GAAACAACGGTCCAAGCAAG
GGAAACGTTGTTGTTTTTCG -> GAAACGTTGTTGTTTTTCGG
GGAAATCGGGCGGTGGGTAC -> GAAATCGGGCGGTGGGTACC
GGAAGTTCCCCAACCCCCTC -> GAAGTTCCCCAACCCCCTCC
GGACGCCGTTTCGCCCGCTA -> GACGCCGTTTCGCCCGCTAG
GGACGCTAACAGCTTGTATA -> GACGCTAACAGCTTGTATAG
GGAGCTTGTGTAGACCATCG -> GAGCTTGTGTAGACCATCGT
GGAGGATACTCACTATCTCG -> GAGGATACTCACTATCTCGC
GGAGGCGTGTAGACAGTCCG -> GAGGCGTGTAGACAGTCCGT
GGAGTCACTGCAATTTCTAG -> GAGTCACTGCAATTTCTAGA
GGATACTCACTATCTCGCCC -> GATACTCACTATCTCGCCCC
GGATCAGAGCCCGGCAATTC -> GATCAGAGCCCGGCAATTCC
GGATCTGACTGCCAAACAAC -> GATCTGACTGCCAAACAACT
GGCAATTAGCGTAGCTGGCC -> GCAATTAGCGTAGCTGGCCC
GGCAATTCCAAAGCGCGTGT -> GCAATTCCAAAGCGCGTGTC
GGCATCCGCGAGTGGGGTTC -> GCATCCGCGAGTGGGGTTCG
GGCCAAAATCGGGAAGTTCC -> GCCAAAATCGGGAAGTTCCC
GGCCCAGGCGAATTGCCTTA -> GCCCAGGCGAATTGCCTTAT
GGCCCCACACCAATGTGGTA -> GCCCCACACCAATGTGGTAT
GGCCTCGCGTCGGCAATTAG -> GCCTCGCGTCGGCAATTAGC
GGCCTTCTAGGGTCCGAATG -> GCCTTCTAGGGTCCGAATGA
GGCGAATTGCCTTATCCACA -> GCGAATTGCCTTATCCACAC
GGCGACCACTATAAAGTCAA -> GCGACCACTATAAAGTCAAC
GGCGCCTTAATCGGATCAGA -> GCGCCTTAATCGGATCAGAG
GGCGCTTCATTCTCGTATGA -> GCGCTTCATTCTCGTATGAC
GGCGGTGGGTACCTTTTAGC -> GCGGTGGGTACCTTTTAGCA
GGCGTGCAACGGGCTATCAC -> GCGTGCAACGGGCTATCACT
GGCGTGTAGACAGTCCGTTT -> GCGTGTAGACAGTCCGTTTA
GGCTATCACTGCCCAAGATC -> GCTATCACTGCCCAAGATCG
GGCTCAATAGACAAACACAT -> GCTCAATAGACAAACACATG
GGCTCCGTATAGGTTCCGGG -> GCTCCGTATAGGTTCCGGGT
GGCTTCGCACCCTAGCACGC -> GCTTCGCACCCTAGCACGCT
GGCTTGCGGAGCTTGTGTAG -> GCTTGCGGAGCTTGTGTAGA
GGGAAACGTTGTTGTTTTTC -> GGAAACGTTGTTGTTTTTCG
GGGAAGTTCCCCAACCCCCT -> GGAAGTTCCCCAACCCCCTC
GGGCGGTGGGTACCTTTTAG -> GGCGGTGGGTACCTTTTAGC
GGGCTATCACTGCCCAAGAT -> GGCTATCACTGCCCAAGATC
GGGCTTCGCACCCTAGCACG -> GGCTTCGCACCCTAGCACGC
GGGCTTGCGGAGCTTGTGTA -> GGCTTGCGGAGCTTGTGTAG
GGGGAAACGTTGTTGTTTTT -> GGGAAACGTTGTTGTTTTTC
GGGGGAAACGTTGTTGTTTT -> GGGGAAACGTTGTTGTTTTT
GGGGTGGTTAACATACGTGT -> GGGTGGTTAACATACGTGTG
GGGGTTCGGAAACAACGGTC -> GGGTTCGGAAACAACGGTCC
GGGTACCTTTTAGCAGGGCT -> GGTACCTTTTAGCAGGGCTT
GGGTAGTTGGACGCCGTTTC -> GGTAGTTGGACGCCGTTTCG
GGGTCCGAATGAGGGTAGTT -> GGTCCGAATGAGGGTAGTTG
GGGTGCGTGGGCTTCGCACC -> GGTGCGTGGGCTTCGCACCC
GGGTGGTTAACATACGTGTG -> GGTGGTTAACATACGTGTGG
GGGTGTATTTTGCATCGCCA -> GGTGTATTTTGCATCGCCAT
GGGTTCGGAAACAACGGTCC -> GGTTCGGAAACAACGGTCCA
GGTACCTTTTAGCAGGGCTT -> GTACCTTTTAGCAGGGCTTG
GGTACTATCGTAGCAAGTTG -> GTACTATCGTAGCAAGTTGG
GGTAGTTGGACGCCGTTTCG -> GTAGTTGGACGCCGTTTCGC
GGTATTTTGGAGGCGTGTAG -> GTATTTTGGAGGCGTGTAGA
GGTCCAAGCAAGATCGTCGT -> GTCCAAGCAAGATCGTCGTT
GGTCCGAATGAGGGTAGTTG -> GTCCGAATGAGGGTAGTTGG
GGTCGTCACAAATGACCAAG -> GTCGTCACAAATGACCAAGG
GGTCTGGAGGATACTCACTA -> GTCTGGAGGATACTCACTAT
GGTGCGTGGGCTTCGCACCC -> GTGCGTGGGCTTCGCACCCT
GGTGGGTACCTTTTAGCAGG -> GTGGGTACCTTTTAGCAGGG
GGTGGTTAACATACGTGTGG -> GTGGTTAACATACGTGTGGA
GGTGTATTTTGCATCGCCAT -> GTGTATTTTGCATCGCCATC
GGTGTGAGGCTCCGTATAGG -> GTGTGAGGCTCCGTATAGGT
GGTTAAAGGTCGTCACAAAT -> GTTAAAGGTCGTCACAAATG
GGTTAACATACGTGTGGATC -> GTTAACATACGTGTGGATCT
GGTTCCGGGTGTATTTTGCA -> GTTCCGGGTGTATTTTGCAT
GGTTCGGAAACAACGGTCCA -> GTTCGGAAACAACGGTCCAA
GGTTGTGCCGATTAGAGAGG -> GTTGTGCCGATTAGAGAGGT
GGTTTGGGGGAAACGTTGTT -> GTTTGGGGGAAACGTTGTTG
GTAACAAATTATGAAGGCGC -> TAACAAATTATGAAGGCGCC
GTACCTTTTAGCAGGGCTTG -> TACCTTTTAGCAGGGCTTGC
GTACGCATTGGCCAAAATCG -> TACGCATTGGCCAAAATCGG
GTACTATCGTAGCAAGTTGG -> TACTATCGTAGCAAGTTGGT
GTAGACAGTCCGTTTACTGG -> TAGACAGTCCGTTTACTGGG
GTAGACCATCGTCATCCACG -> TAGACCATCGTCATCCACGA
GTAGCAAGTTGGTCTGGAGG -> TAGCAAGTTGGTCTGGAGGA
GTAGCTGGCCCAGGCGAATT -> TAGCTGGCCCAGGCGAATTG
GTAGTTGGACGCCGTTTCGC -> TAGTTGGACGCCGTTTCGCC
GTATAGGTTCCGGGTGTATT -> TATAGGTTCCGGGTGTATTT
GTATAGTATTACATCCGGCG -> TATAGTATTACATCCGGCGC
GTATGACATCACCCAGCTAA -> TATGACATCACCCAGCTAAG
GTATTACATCCGGCGCTTCA -> TATTACATCCGGCGCTTCAT
GTATTCACGTCCTTGTAACA -> TATTCACGTCCTTGTAACAA
GTATTGGCTCAATAGACAAA -> TATTGGCTCAATAGACAAAC
GTATTTCGGCCTCGCGTCGG -> TATTTCGGCCTCGCGTCGGC
GTATTTTGCATCGCCATCTT -> TATTTTGCATCGCCATCTTG
GTATTTTGGAGGCGTGTAGA -> TATTTTGGAGGCGTGTAGAC
GTCAACTGGTGTGAGGCTCC -> TCAACTGGTGTGAGGCTCCG
GTCACAAATGACCAAGGTAC -> TCACAAATGACCAAGGTACT
GTCACCTAAGAAAAGGCCCC -> TCACCTAAGAAAAGGCCCCA
GTCACTGCAATTTCTAGAAC -> TCACTGCAATTTCTAGAACA
GTCATCCACGAACCGAAGAT -> TCATCCACGAACCGAAGATA
GTCCAAGCAAGATCGTCGTT -> TCCAAGCAAGATCGTCGTTT
GTCCACCTAGTTTTCTTAGC -> TCCACCTAGTTTTCTTAGCG
GTCCGAATGAGGGTAGTTGG -> TCCGAATGAGGGTAGTTGGA
GTCCGTTTACTGGGTGCGTG -> TCCGTTTACTGGGTGCGTGG
GTCCTTGTAACAAATTATGA -> TCCTTGTAACAAATTATGAA
GTCGGCAATTAGCGTAGCTG -> TCGGCAATTAGCGTAGCTGG
GTCGTCACAAATGACCAAGG -> TCGTCACAAATGACCAAGGT
GTCGTTTCATCTCCCATTTA -> TCGTTTCATCTCCCATTTAA
GTCTGGAGGATACTCACTAT -> TCTGGAGGATACTCACTATC
GTGAGGCTCCGTATAGGTTC -> TGAGGCTCCGTATAGGTTCC
GTGCAACGGGCTATCACTGC -> TGCAACGGGCTATCACTGCC
GTGCCGATTAGAGAGGTTTG -> TGCCGATTAGAGAGGTTTGG
GTGCGTGGGCTTCGCACCCT -> TGCGTGGGCTTCGCACCCTA
GTGCTGGCGTGCAACGGGCT -> TGCTGGCGTGCAACGGGCTA
GTGGACGCTAACAGCTTGTA -> TGGACGCTAACAGCTTGTAT
GTGGATCTGACTGCCAAACA -> TGGATCTGACTGCCAAACAA
GTGGGCTTCGCACCCTAGCA -> TGGGCTTCGCACCCTAGCAC
GTGGGGTTCGGAAACAACGG -> TGGGGTTCGGAAACAACGGT
GTGGGTACCTTTTAGCAGGG -> TGGGTACCTTTTAGCAGGGC
GTGGTATTTTGGAGGCGTGT -> TGGTATTTTGGAGGCGTGTA
GTGGTTAACATACGTGTGGA -> TGGTTAACATACGTGTGGAT
GTGTAGACAGTCCGTTTACT -> TGTAGACAGTCCGTTTACTG
GTGTAGACCATCGTCATCCA -> TGTAGACCATCGTCATCCAC
GTGTATTTTGCATCGCCATC -> TGTATTTTGCATCGCCATCT
GTGTCCACCTAGTTTTCTTA -> TGTCCACCTAGTTTTCTTAG
GTGTGAGGCTCCGTATAGGT -> TGTGAGGCTCCGTATAGGTT
GTGTGCTGGCGTGCAACGGG -> TGTGCTGGCGTGCAACGGGC
GTGTGGATCTGACTGCCAAA -> TGTGGATCTGACTGCCAAAC
GTTAAAGGTCGTCACAAATG -> TTAAAGGTCGTCACAAATGA
GTTAACATACGTGTGGATCT -> TTAACATACGTGTGGATCTG
GTTATTGTTTATACGATTAC -> TTATTGTTTATACGATTACG
GTTCCCCAACCCCCTCCTAA -> TTCCCCAACCCCCTCCTAAA
GTTCCGGGTGTATTTTGCAT -> TTCCGGGTGTATTTTGCATC
GTTCGGAAACAACGGTCCAA -> TTCGGAAACAACGGTCCAAG
GTTGGACGCCGTTTCGCCCG -> TTGGACGCCGTTTCGCCCGC
GTTGGTCTGGAGGATACTCA -> TTGGTCTGGAGGATACTCAC
GTTGTGCCGATTAGAGAGGT -> TTGTGCCGATTAGAGAGGTT
GTTGTTGTTTTTCGGCCTTC -> TTGTTGTTTTTCGGCCTTCT
GTTGTTTTTCGGCCTTCTAG -> TTGTTTTTCGGCCTTCTAGG
GTTTACTGGGTGCGTGGGCT -> TTTACTGGGTGCGTGGGCTT
GTTTATACGATTACGATGTA -> TTTATACGATTACGATGTAT
GTTTCATCTCCCATTTAACA -> TTTCATCTCCCATTTAACAG
GTTTCGCCCGCTAGCGGAAA -> TTTCGCCCGCTAGCGGAAAT
GTTTGGGGGAAACGTTGTTG -> TTTGGGGGAAACGTTGTTGT
GTTTTCTTAGCGAGCTAAAT -> TTTTCTTAGCGAGCTAAATT
GTTTTTCGGCCTTCTAGGGT -> TTTTTCGGCCTTCTAGGGTC
TAAAGCCTTCCTCCGTTATT -> AAAGCCTTCCTCCGTTATTG
TAAAGGTCGTCACAAATGAC -> AAAGGTCGTCACAAATGACC
TAAAGTCAACTGGTGTGAGG -> AAAGTCAACTGGTGTGAGGC
TAAATTTCTCTGGTTAAAGG -> AAATTTCTCTGGTTAAAGGT
TAACAAATTATGAAGGCGCC -> AACAAATTATGAAGGCGCCT
TAACAGCGTCACCTAAGAAA -> AACAGCGTCACCTAAGAAAA
TAACAGCTTGTATAGTATTA -> AACAGCTTGTATAGTATTAC
TAACATACGTGTGGATCTGA -> AACATACGTGTGGATCTGAC
TAAGAAAAGGCCCCACACCA -> AAGAAAAGGCCCCACACCAA
TAAGAGATGAGCCCCGAATC -> AAGAGATGAGCCCCGAATCT
TAATCGGATCAGAGCCCGGC -> AATCGGATCAGAGCCCGGCA
TACATCCGGCGCTTCATTCT -> ACATCCGGCGCTTCATTCTC
TACCTTTTAGCAGGGCTTGC -> ACCTTTTAGCAGGGCTTGCG
TACGATGTATTCACGTCCTT -> ACGATGTATTCACGTCCTTG
TACGATTACGATGTATTCAC -> ACGATTACGATGTATTCACG
TACGCATTGGCCAAAATCGG -> ACGCATTGGCCAAAATCGGG
TACGTGTGGATCTGACTGCC -> ACGTGTGGATCTGACTGCCA
TACTATCGTAGCAAGTTGGT -> ACTATCGTAGCAAGTTGGTC
TACTCACTATCTCGCCCCAA -> ACTCACTATCTCGCCCCAAT
TACTGGGTGCGTGGGCTTCG -> ACTGGGTGCGTGGGCTTCGC
TAGAACAATTCAGAATAACC -> AGAACAATTCAGAATAACCA
TAGACAAACACATGGGGTGG -> AGACAAACACATGGGGTGGT
TAGACAGTCCGTTTACTGGG -> AGACAGTCCGTTTACTGGGT
TAGACCATCGTCATCCACGA -> AGACCATCGTCATCCACGAA
TAGAGAGGTTTGGGGGAAAC -> AGAGAGGTTTGGGGGAAACG
TAGCAAGTTGGTCTGGAGGA -> AGCAAGTTGGTCTGGAGGAT
TAGCACGCTGATGTGGACGC -> AGCACGCTGATGTGGACGCT
TAGCAGGGCTTGCGGAGCTT -> AGCAGGGCTTGCGGAGCTTG
TAGCGAGCTAAATTTCTCTG -> AGCGAGCTAAATTTCTCTGG
TAGCGGAAATCGGGCGGTGG -> AGCGGAAATCGGGCGGTGGG
TAGCGTAGCTGGCCCAGGCG -> AGCGTAGCTGGCCCAGGCGA
TAGCTGGCCCAGGCGAATTG -> AGCTGGCCCAGGCGAATTGC
TAGGGTCCGAATGAGGGTAG -> AGGGTCCGAATGAGGGTAGT
TAGGTTCCGGGTGTATTTTG -> AGGTTCCGGGTGTATTTTGC
TAGGTTGTGCCGATTAGAGA -> AGGTTGTGCCGATTAGAGAG
TAGTATTACATCCGGCGCTT -> AGTATTACATCCGGCGCTTC
TAGTATTGGCTCAATAGACA -> AGTATTGGCTCAATAGACAA
TAGTTGGACGCCGTTTCGCC -> AGTTGGACGCCGTTTCGCCC
TAGTTTTCTTAGCGAGCTAA -> AGTTTTCTTAGCGAGCTAAA
TATAAAGTCAACTGGTGTGA -> ATAAAGTCAACTGGTGTGAG
TATACGATTACGATGTATTC -> ATACGATTACGATGTATTCA
TATAGGTTCCGGGTGTATTT -> ATAGGTTCCGGGTGTATTTT
TATAGTATTACATCCGGCGC -> ATAGTATTACATCCGGCGCT
TATAGTATTGGCTCAATAGA -> ATAGTATTGGCTCAATAGAC
TATCACTGCCCAAGATCGTA -> ATCACTGCCCAAGATCGTAC
TATCAGGCGACCACTATAAA -> ATCAGGCGACCACTATAAAG
TATCCACACTATGGCATCCG -> ATCCACACTATGGCATCCGC
TATCGTAGCAAGTTGGTCTG -> ATCGTAGCAAGTTGGTCTGG
TATCTCGCCCCAATATTTAT -> ATCTCGCCCCAATATTTATC
TATGAAGGCGCCTTAATCGG -> ATGAAGGCGCCTTAATCGGA
TATGACATCACCCAGCTAAG -> ATGACATCACCCAGCTAAGA
TATGGCATCCGCGAGTGGGG -> ATGGCATCCGCGAGTGGGGT
TATTACATCCGGCGCTTCAT -> ATTACATCCGGCGCTTCATT
TATTCACGTCCTTGTAACAA -> ATTCACGTCCTTGTAACAAA
TATTGGCTCAATAGACAAAC -> ATTGGCTCAATAGACAAACA
TATTGTTTATACGATTACGA -> ATTGTTTATACGATTACGAT
TATTTATCAGGCGACCACTA -> ATTTATCAGGCGACCACTAT
TATTTCGGCCTCGCGTCGGC -> ATTTCGGCCTCGCGTCGGCA
TATTTTGCATCGCCATCTTG -> ATTTTGCATCGCCATCTTGC
TATTTTGGAGGCGTGTAGAC -> ATTTTGGAGGCGTGTAGACA
TCAACTGGTGTGAGGCTCCG -> CAACTGGTGTGAGGCTCCGT
TCAATAGACAAACACATGGG -> CAATAGACAAACACATGGGG
TCACAAATGACCAAGGTACT -> CACAAATGACCAAGGTACTA
TCACCCAGCTAAGAGATGAG -> CACCCAGCTAAGAGATGAGC
TCACCTAAGAAAAGGCCCCA -> CACCTAAGAAAAGGCCCCAC
TCACGTCCTTGTAACAAATT -> CACGTCCTTGTAACAAATTA
TCACTATCTCGCCCCAATAT -> CACTATCTCGCCCCAATATT
TCACTGCAATTTCTAGAACA -> CACTGCAATTTCTAGAACAA
TCACTGCCCAAGATCGTACG -> CACTGCCCAAGATCGTACGC
TCAGAGCCCGGCAATTCCAA -> CAGAGCCCGGCAATTCCAAA
TCAGGCGACCACTATAAAGT -> CAGGCGACCACTATAAAGTC
TCATCCACGAACCGAAGATA -> CATCCACGAACCGAAGATAT
TCATCTCCCATTTAACAGCG -> CATCTCCCATTTAACAGCGT
TCATTCTCGTATGACATCAC -> CATTCTCGTATGACATCACC
TCCAAAGCGCGTGTCCACCT -> CCAAAGCGCGTGTCCACCTA
TCCAAGCAAGATCGTCGTTT -> CCAAGCAAGATCGTCGTTTC
TCCACACTATGGCATCCGCG -> CCACACTATGGCATCCGCGA
TCCACCTAGTTTTCTTAGCG -> CCACCTAGTTTTCTTAGCGA
TCCACGAACCGAAGATATAG -> CCACGAACCGAAGATATAGT
TCCCATTTAACAGCGTCACC -> CCCATTTAACAGCGTCACCT
TCCCCAACCCCCTCCTAAAG -> CCCCAACCCCCTCCTAAAGC
TCCGAATGAGGGTAGTTGGA -> CCGAATGAGGGTAGTTGGAC
TCCGCGAGTGGGGTTCGGAA -> CCGCGAGTGGGGTTCGGAAA
TCCGGCGCTTCATTCTCGTA -> CCGGCGCTTCATTCTCGTAT
TCCGGGTGTATTTTGCATCG -> CCGGGTGTATTTTGCATCGC
TCCGTATAGGTTCCGGGTGT -> CCGTATAGGTTCCGGGTGTA
TCCGTTATTGTTTATACGAT -> CCGTTATTGTTTATACGATT
TCCGTTTACTGGGTGCGTGG -> CCGTTTACTGGGTGCGTGGG
TCCTAAAGCCTTCCTCCGTT -> CCTAAAGCCTTCCTCCGTTA
TCCTCCGTTATTGTTTATAC -> CCTCCGTTATTGTTTATACG
TCCTTGTAACAAATTATGAA -> CCTTGTAACAAATTATGAAG
TCGCACCCTAGCACGCTGAT -> CGCACCCTAGCACGCTGATG
TCGCCATCTTGCATTAGGTT -> CGCCATCTTGCATTAGGTTG
TCGCCCCAATATTTATCAGG -> CGCCCCAATATTTATCAGGC
TCGCCCGCTAGCGGAAATCG -> CGCCCGCTAGCGGAAATCGG
TCGCGTCGGCAATTAGCGTA -> CGCGTCGGCAATTAGCGTAG
TCGGAAACAACGGTCCAAGC -> CGGAAACAACGGTCCAAGCA
TCGGAGTCACTGCAATTTCT -> CGGAGTCACTGCAATTTCTA
TCGGATCAGAGCCCGGCAAT -> CGGATCAGAGCCCGGCAATT
TCGGCAATTAGCGTAGCTGG -> CGGCAATTAGCGTAGCTGGC
TCGGCCTCGCGTCGGCAATT -> CGGCCTCGCGTCGGCAATTA
TCGGCCTTCTAGGGTCCGAA -> CGGCCTTCTAGGGTCCGAAT
TCGGGAAGTTCCCCAACCCC -> CGGGAAGTTCCCCAACCCCC
TCGGGCGGTGGGTACCTTTT -> CGGGCGGTGGGTACCTTTTA
TCGTACGCATTGGCCAAAAT -> CGTACGCATTGGCCAAAATC
TCGTAGCAAGTTGGTCTGGA -> CGTAGCAAGTTGGTCTGGAG
TCGTATGACATCACCCAGCT -> CGTATGACATCACCCAGCTA
TCGTCACAAATGACCAAGGT -> CGTCACAAATGACCAAGGTA
TCGTCATCCACGAACCGAAG -> CGTCATCCACGAACCGAAGA
TCGTCGTTTCATCTCCCATT -> CGTCGTTTCATCTCCCATTT
TCGTTTCATCTCCCATTTAA -> CGTTTCATCTCCCATTTAAC
TCTAGAACAATTCAGAATAA -> CTAGAACAATTCAGAATAAC
TCTAGGGTCCGAATGAGGGT -> CTAGGGTCCGAATGAGGGTA
TCTCCCATTTAACAGCGTCA -> CTCCCATTTAACAGCGTCAC
TCTCGCCCCAATATTTATCA -> CTCGCCCCAATATTTATCAG
TCTCGTATGACATCACCCAG -> CTCGTATGACATCACCCAGC
TCTCTGGTTAAAGGTCGTCA -> CTCTGGTTAAAGGTCGTCAC
TCTGACTGCCAAACAACTGT -> CTGACTGCCAAACAACTGTA
TCTGCTTGCAATTCGGAGTC -> CTGCTTGCAATTCGGAGTCA
TCTGGAGGATACTCACTATC -> CTGGAGGATACTCACTATCT
TCTGGTTAAAGGTCGTCACA -> CTGGTTAAAGGTCGTCACAA
TCTTAGCGAGCTAAATTTCT -> CTTAGCGAGCTAAATTTCTC
TCTTGCATTAGGTTGTGCCG -> CTTGCATTAGGTTGTGCCGA
TGAAGGCGCCTTAATCGGAT -> GAAGGCGCCTTAATCGGATC
TGACATCACCCAGCTAAGAG -> GACATCACCCAGCTAAGAGA
TGACCAAGGTACTATCGTAG -> GACCAAGGTACTATCGTAGC
TGACTGCCAAACAACTGTAT -> GACTGCCAAACAACTGTATT
TGAGCCCCGAATCTGCTTGC -> GAGCCCCGAATCTGCTTGCA
TGAGGCTCCGTATAGGTTCC -> GAGGCTCCGTATAGGTTCCG
TGAGGGTAGTTGGACGCCGT -> GAGGGTAGTTGGACGCCGTT
TGATGTGGACGCTAACAGCT -> GATGTGGACGCTAACAGCTT
TGCAACGGGCTATCACTGCC -> GCAACGGGCTATCACTGCCC
TGCAATTCGGAGTCACTGCA -> GCAATTCGGAGTCACTGCAA
TGCAATTTCTAGAACAATTC -> GCAATTTCTAGAACAATTCA
TGCATCGCCATCTTGCATTA -> GCATCGCCATCTTGCATTAG
TGCATTAGGTTGTGCCGATT -> GCATTAGGTTGTGCCGATTA
TGCCAAACAACTGTATTTCG -> GCCAAACAACTGTATTTCGG
TGCCCAAGATCGTACGCATT -> GCCCAAGATCGTACGCATTG
TGCCGATTAGAGAGGTTTGG -> GCCGATTAGAGAGGTTTGGG
TGCCTTATCCACACTATGGC -> GCCTTATCCACACTATGGCA
TGCGGAGCTTGTGTAGACCA -> GCGGAGCTTGTGTAGACCAT
TGCGTGGGCTTCGCACCCTA -> GCGTGGGCTTCGCACCCTAG
TGCTGGCGTGCAACGGGCTA -> GCTGGCGTGCAACGGGCTAT
TGCTTGCAATTCGGAGTCAC -> GCTTGCAATTCGGAGTCACT
TGGACGCCGTTTCGCCCGCT -> GGACGCCGTTTCGCCCGCTA
TGGACGCTAACAGCTTGTAT -> GGACGCTAACAGCTTGTATA
TGGAGGATACTCACTATCTC -> GGAGGATACTCACTATCTCG
TGGAGGCGTGTAGACAGTCC -> GGAGGCGTGTAGACAGTCCG
TGGATCTGACTGCCAAACAA -> GGATCTGACTGCCAAACAAC
TGGCATCCGCGAGTGGGGTT -> GGCATCCGCGAGTGGGGTTC
TGGCCAAAATCGGGAAGTTC -> GGCCAAAATCGGGAAGTTCC
TGGCCCAGGCGAATTGCCTT -> GGCCCAGGCGAATTGCCTTA
TGGCGTGCAACGGGCTATCA -> GGCGTGCAACGGGCTATCAC
TGGCTCAATAGACAAACACA -> GGCTCAATAGACAAACACAT
TGGGCTTCGCACCCTAGCAC -> GGGCTTCGCACCCTAGCACG
TGGGGGAAACGTTGTTGTTT -> GGGGGAAACGTTGTTGTTTT
TGGGGTGGTTAACATACGTG -> GGGGTGGTTAACATACGTGT
TGGGGTTCGGAAACAACGGT -> GGGGTTCGGAAACAACGGTC
TGGGTACCTTTTAGCAGGGC -> GGGTACCTTTTAGCAGGGCT
TGGGTGCGTGGGCTTCGCAC -> GGGTGCGTGGGCTTCGCACC
TGGTATTTTGGAGGCGTGTA -> GGTATTTTGGAGGCGTGTAG
TGGTCTGGAGGATACTCACT -> GGTCTGGAGGATACTCACTA
TGGTGTGAGGCTCCGTATAG -> GGTGTGAGGCTCCGTATAGG
TGGTTAAAGGTCGTCACAAA -> GGTTAAAGGTCGTCACAAAT
TGGTTAACATACGTGTGGAT -> GGTTAACATACGTGTGGATC
TGTAACAAATTATGAAGGCG -> GTAACAAATTATGAAGGCGC
TGTAGACAGTCCGTTTACTG -> GTAGACAGTCCGTTTACTGG
TGTAGACCATCGTCATCCAC -> GTAGACCATCGTCATCCACG
TGTATAGTATTACATCCGGC -> GTATAGTATTACATCCGGCG
TGTATTCACGTCCTTGTAAC -> GTATTCACGTCCTTGTAACA
TGTATTTCGGCCTCGCGTCG -> GTATTTCGGCCTCGCGTCGG
TGTATTTTGCATCGCCATCT -> GTATTTTGCATCGCCATCTT
TGTCCACCTAGTTTTCTTAG -> GTCCACCTAGTTTTCTTAGC
TGTGAGGCTCCGTATAGGTT -> GTGAGGCTCCGTATAGGTTC
TGTGCCGATTAGAGAGGTTT -> GTGCCGATTAGAGAGGTTTG
TGTGCTGGCGTGCAACGGGC -> GTGCTGGCGTGCAACGGGCT
TGTGGACGCTAACAGCTTGT -> GTGGACGCTAACAGCTTGTA
TGTGGATCTGACTGCCAAAC -> GTGGATCTGACTGCCAAACA
TGTGGTATTTTGGAGGCGTG -> GTGGTATTTTGGAGGCGTGT
TGTGTAGACCATCGTCATCC -> GTGTAGACCATCGTCATCCA
TGTGTGCTGGCGTGCAACGG -> GTGTGCTGGCGTGCAACGGG
TGTTGTTTTTCGGCCTTCTA -> GTTGTTTTTCGGCCTTCTAG
TGTTTATACGATTACGATGT -> GTTTATACGATTACGATGTA
TGTTTTTCGGCCTTCTAGGG -> GTTTTTCGGCCTTCTAGGGT
TTAAAGGTCGTCACAAATGA -> TAAAGGTCGTCACAAATGAC
TTAACAGCGTCACCTAAGAA -> TAACAGCGTCACCTAAGAAA
TTAACATACGTGTGGATCTG -> TAACATACGTGTGGATCTGA
TTAATCGGATCAGAGCCCGG -> TAATCGGATCAGAGCCCGGC
TTACATCCGGCGCTTCATTC -> TACATCCGGCGCTTCATTCT
TTACGATGTATTCACGTCCT -> TACGATGTATTCACGTCCTT
TTACTGGGTGCGTGGGCTTC -> TACTGGGTGCGTGGGCTTCG
TTAGAGAGGTTTGGGGGAAA -> TAGAGAGGTTTGGGGGAAAC
TTAGCAGGGCTTGCGGAGCT -> TAGCAGGGCTTGCGGAGCTT
TTAGCGAGCTAAATTTCTCT -> TAGCGAGCTAAATTTCTCTG
TTAGCGTAGCTGGCCCAGGC -> TAGCGTAGCTGGCCCAGGCG
TTAGGTTGTGCCGATTAGAG -> TAGGTTGTGCCGATTAGAGA
TTATACGATTACGATGTATT -> TATACGATTACGATGTATTC
TTATCAGGCGACCACTATAA -> TATCAGGCGACCACTATAAA
TTATCCACACTATGGCATCC -> TATCCACACTATGGCATCCG
TTATGAAGGCGCCTTAATCG -> TATGAAGGCGCCTTAATCGG
TTATTGTTTATACGATTACG -> TATTGTTTATACGATTACGA
TTCACGTCCTTGTAACAAAT -> TCACGTCCTTGTAACAAATT
TTCAGAATAACCAGTCCGTC -> TCAGAATAACCAGTCCGTCA
TTCATCTCCCATTTAACAGC -> TCATCTCCCATTTAACAGCG
TTCATTCTCGTATGACATCA -> TCATTCTCGTATGACATCAC
TTCCAAAGCGCGTGTCCACC -> TCCAAAGCGCGTGTCCACCT
TTCCCCAACCCCCTCCTAAA -> TCCCCAACCCCCTCCTAAAG
TTCCGGGTGTATTTTGCATC -> TCCGGGTGTATTTTGCATCG
TTCCTCCGTTATTGTTTATA -> TCCTCCGTTATTGTTTATAC
TTCGCACCCTAGCACGCTGA -> TCGCACCCTAGCACGCTGAT
TTCGCCCGCTAGCGGAAATC -> TCGCCCGCTAGCGGAAATCG
TTCGGAAACAACGGTCCAAG -> TCGGAAACAACGGTCCAAGC
TTCGGAGTCACTGCAATTTC -> TCGGAGTCACTGCAATTTCT
TTCGGCCTCGCGTCGGCAAT -> TCGGCCTCGCGTCGGCAATT
TTCGGCCTTCTAGGGTCCGA -> TCGGCCTTCTAGGGTCCGAA
TTCTAGAACAATTCAGAATA -> TCTAGAACAATTCAGAATAA
TTCTAGGGTCCGAATGAGGG -> TCTAGGGTCCGAATGAGGGT
TTCTCGTATGACATCACCCA -> TCTCGTATGACATCACCCAG
TTCTCTGGTTAAAGGTCGTC -> TCTCTGGTTAAAGGTCGTCA
TTCTTAGCGAGCTAAATTTC -> TCTTAGCGAGCTAAATTTCT
TTGCAATTCGGAGTCACTGC -> TGCAATTCGGAGTCACTGCA
TTGCATCGCCATCTTGCATT -> TGCATCGCCATCTTGCATTA
TTGCATTAGGTTGTGCCGAT -> TGCATTAGGTTGTGCCGATT
TTGCCTTATCCACACTATGG -> TGCCTTATCCACACTATGGC
TTGCGGAGCTTGTGTAGACC -> TGCGGAGCTTGTGTAGACCA
TTGGACGCCGTTTCGCCCGC -> TGGACGCCGTTTCGCCCGCT
TTGGAGGCGTGTAGACAGTC -> TGGAGGCGTGTAGACAGTCC
TTGGCCAAAATCGGGAAGTT -> TGGCCAAAATCGGGAAGTTC
TTGGCTCAATAGACAAACAC -> TGGCTCAATAGACAAACACA
TTGGGGGAAACGTTGTTGTT -> TGGGGGAAACGTTGTTGTTT
TTGGTCTGGAGGATACTCAC -> TGGTCTGGAGGATACTCACT
TTGTAACAAATTATGAAGGC -> TGTAACAAATTATGAAGGCG
TTGTATAGTATTACATCCGG -> TGTATAGTATTACATCCGGC
TTGTGCCGATTAGAGAGGTT -> TGTGCCGATTAGAGAGGTTT
TTGTGTAGACCATCGTCATC -> TGTGTAGACCATCGTCATCC
TTGTGTGCTGGCGTGCAACG -> TGTGTGCTGGCGTGCAACGG
TTGTTGTTTTTCGGCCTTCT -> TGTTGTTTTTCGGCCTTCTA
TTGTTTATACGATTACGATG -> TGTTTATACGATTACGATGT
TTGTTTTTCGGCCTTCTAGG -> TGTTTTTCGGCCTTCTAGGG
TTTAACAGCGTCACCTAAGA -> TTAACAGCGTCACCTAAGAA
TTTACTGGGTGCGTGGGCTT -> TTACTGGGTGCGTGGGCTTC
TTTAGCAGGGCTTGCGGAGC -> TTAGCAGGGCTTGCGGAGCT
TTTATACGATTACGATGTAT -> TTATACGATTACGATGTATT
TTTATCAGGCGACCACTATA -> TTATCAGGCGACCACTATAA
TTTCATCTCCCATTTAACAG -> TTCATCTCCCATTTAACAGC
TTTCGCCCGCTAGCGGAAAT -> TTCGCCCGCTAGCGGAAATC
TTTCGGCCTCGCGTCGGCAA -> TTCGGCCTCGCGTCGGCAAT
TTTCGGCCTTCTAGGGTCCG -> TTCGGCCTTCTAGGGTCCGA
TTTCTAGAACAATTCAGAAT -> TTCTAGAACAATTCAGAATA
TTTCTCTGGTTAAAGGTCGT -> TTCTCTGGTTAAAGGTCGTC
TTTCTTAGCGAGCTAAATTT -> TTCTTAGCGAGCTAAATTTC
TTTGCATCGCCATCTTGCAT -> TTGCATCGCCATCTTGCATT
TTTGGAGGCGTGTAGACAGT -> TTGGAGGCGTGTAGACAGTC
TTTGGGGGAAACGTTGTTGT -> TTGGGGGAAACGTTGTTGTT
TTTGTGTGCTGGCGTGCAAC -> TTGTGTGCTGGCGTGCAACG
TTTTAGCAGGGCTTGCGGAG -> TTTAGCAGGGCTTGCGGAGC
TTTTCGGCCTTCTAGGGTCC -> TTTCGGCCTTCTAGGGTCCG
TTTTCTTAGCGAGCTAAATT -> TTTCTTAGCGAGCTAAATTT
TTTTGCATCGCCATCTTGCA -> TTTGCATCGCCATCTTGCAT
TTTTGGAGGCGTGTAGACAG -> TTTGGAGGCGTGTAGACAGT
TTTTTCGGCCTTCTAGGGTC -> TTTTCGGCCTTCTAGGGTCC
