AAAAATCGGCA -> AAAATCGGCAC
AAAAGCAAGAT -> AAAGCAAGATA
AAAAGTCCGCT -> AAAGTCCGCTT
AAAATATGGGG -> AAATATGGGGC
AAAATCGGCAC -> AAATCGGCACA
AAACAACCTCT -> AACAACCTCTA
AAACCGTGACC -> AACCGTGACCA
AAACGAAGATC -> AACGAAGATCG
AAACGTGTCTC -> AACGTGTCTCT
AAACGTTCCAG -> AACGTTCCAGG
AAAGAATCTGA -> AAGAATCTGAT
AAAGATAACAT -> AAGATAACATG
AAAGATATTTA -> AAGATATTTAC
AAAGCAAGATA -> AAGCAAGATAA
AAAGCCCTAGG -> AAGCCCTAGGA
AAAGCCGTGGT -> AAGCCGTGGTC
AAAGCCTCAAC -> AAGCCTCAACG
AAAGGATTAGA -> AAGGATTAGAT
AAAGTCCGCTT -> AAGTCCGCTTC
AAAGTGGTCTG -> AAGTGGTCTGA
AAAGTTCGTCG -> AAGTTCGTCGT
AAATATGGGGC -> AATATGGGGCA
AAATCCTTGAT -> AATCCTTGATA
AAATCGGCACA -> AATCGGCACAG
AAATCTCTCCA -> AATCTCTCCAT
AAATGACCAAC -> AATGACCAACC
AAATGTAAAGC -> AATGTAAAGCC
AAATTAACTAG -> AATTAACTAGC
AAATTGAGGGG -> AATTGAGGGGG
AAATTTCGTCC -> AATTTCGTCCC
AACAACCTCTA -> ACAACCTCTAG
AACAGAAAGCC -> ACAGAAAGCCG
AACATGACAAC -> ACATGACAACG
AACCAGAGACG -> ACCAGAGACGG
AACCAGGTTTA -> ACCAGGTTTAA
AACCATGGACA -> ACCATGGACAT
AACCATTCCAG -> ACCATTCCAGG
AACCCCAATCG -> ACCCCAATCGA
AACCCTAACCT -> ACCCTAACCTA
AACCGCCCCCC -> ACCGCCCCCCC
AACCGTGACCA -> ACCGTGACCAG
AACCTATCGCG -> ACCTATCGCGG
AACCTCTAGGA -> ACCTCTAGGAG
AACCTGGCAGC -> ACCTGGCAGCG
AACGAAGATCG -> ACGAAGATCGT
AACGACTACAT -> ACGACTACATT
AACGATGGAGG -> ACGATGGAGGA
AACGCCAGATT -> ACGCCAGATTG
AACGCTCATTA -> ACGCTCATTAG
AACGGACGTCC -> ACGGACGTCCC
AACGGAGCATA -> ACGGAGCATAA
AACGGTTTGAG -> ACGGTTTGAGT
AACGTGAGCCA -> ACGTGAGCCAA
AACGTGCCCGG -> ACGTGCCCGGA
AACGTGTCTCT -> ACGTGTCTCTT
AACGTGTTGAT -> ACGTGTTGATG
AACGTTCCAGG -> ACGTTCCAGGC
AACTAGCTGGT -> ACTAGCTGGTT
AACTATCATAT -> ACTATCATATT
AACTCCCAAAC -> ACTCCCAAACA
AACTCCTACAT -> ACTCCTACATT
AACTGCGACGG -> ACTGCGACGGC
AACTTAACCAG -> ACTTAACCAGA
AAGAAACGTGT -> AGAAACGTGTC
AAGAAGTGAAG -> AGAAGTGAAGC
AAGAATCTGAT -> AGAATCTGATA
AAGACCAGTAT -> AGACCAGTATG
AAGATAACATG -> AGATAACATGA
AAGATAATAAC -> AGATAATAACG
AAGATATTTAC -> AGATATTTACG
AAGATCGTACA -> AGATCGTACAG
AAGCAAGATAA -> AGCAAGATAAT
AAGCCAAGTCC -> AGCCAAGTCCA
AAGCCAGTGGC -> AGCCAGTGGCG
AAGCCCTAGGA -> AGCCCTAGGAT
AAGCCGTGGTC -> AGCCGTGGTCG
AAGCCTCAACG -> AGCCTCAACGT
AAGCGGTACGG -> AGCGGTACGGG
AAGCGTGGGAG -> AGCGTGGGAGC
AAGCTAATGTC -> AGCTAATGTCG
AAGCTCGTCCT -> AGCTCGTCCTG
AAGCTGGAACC -> AGCTGGAACCC
AAGGATTAGAT -> AGGATTAGATT
AAGGTACACAA -> AGGTACACAAG
AAGTACAATTA -> AGTACAATTAA
AAGTAGGTATG -> AGTAGGTATGG
AAGTAGTAGTG -> AGTAGTAGTGC
AAGTCAAAAAT -> AGTCAAAAATC
AAGTCCACGAG -> AGTCCACGAGC
AAGTCCACTGT -> AGTCCACTGTC
AAGTCCGCTTC -> AGTCCGCTTCC
AAGTCTGTTGA -> AGTCTGTTGAG
AAGTGAAGCGG -> AGTGAAGCGGT
AAGTGGTCTGA -> AGTGGTCTGAG
AAGTTCGTCGT -> AGTTCGTCGTT
AATAACGTGCC -> ATAACGTGCCC
AATACCCGTCC -> ATACCCGTCCA
AATAGACCGAA -> ATAGACCGAAA
AATAGGACTTC -> ATAGGACTTCA
AATATGGGGCA -> ATATGGGGCAA
AATCAAGCCAG -> ATCAAGCCAGT
AATCACCGTTC -> ATCACCGTTCG
AATCCTTGATA -> ATCCTTGATAC
AATCGAGACGT -> ATCGAGACGTT
AATCGAGTGGC -> ATCGAGTGGCA
AATCGCAGCCT -> ATCGCAGCCTC
AATCGGCACAG -> ATCGGCACAGG
AATCGTCACTG -> ATCGTCACTGG
AATCTACACGA -> ATCTACACGAG
AATCTCTCCAT -> ATCTCTCCATA
AATCTGATAAC -> ATCTGATAACT
AATCTTCGATG -> ATCTTCGATGC
AATGAACAGAA -> ATGAACAGAAA
AATGACCAACC -> ATGACCAACCA
AATGAGTGACG -> ATGAGTGACGG
AATGATATCAT -> ATGATATCATC
AATGGATTGTC -> ATGGATTGTCG
AATGTAAAGCC -> ATGTAAAGCCC
AATGTACGTCG -> ATGTACGTCGT
AATGTCGCCGG -> ATGTCGCCGGT
AATTAACTAGC -> ATTAACTAGCT
AATTAATTGCA -> ATTAATTGCAC
AATTCAGCAAC -> ATTCAGCAACT
AATTCCGAACT -> ATTCCGAACTC
AATTGAGGGGG -> ATTGAGGGGGC
AATTGCACAGG -> ATTGCACAGGT
AATTGTGAGGA -> ATTGTGAGGAC
AATTTCGTCCC -> ATTTCGTCCCT
ACAAAAGTCCG -> CAAAAGTCCGC
ACAAAGTGGTC -> CAAAGTGGTCT
ACAACCTCTAG -> CAACCTCTAGG
ACAACGACTAC -> CAACGACTACA
ACAAGAAGTGA -> CAAGAAGTGAA
ACAAGCTGGAA -> CAAGCTGGAAC
ACAATCGTCAC -> CAATCGTCACT
ACAATGTACGT -> CAATGTACGTC
ACAATTAATTG -> CAATTAATTGC
ACAATTCAGCA -> CAATTCAGCAA
ACAATTCCGAA -> CAATTCCGAAC
ACAATTGTGAG -> CAATTGTGAGG
ACACAAAAGTC -> CACAAAAGTCC
ACACAAGCTGG -> CACAAGCTGGA
ACACGAGTATG -> CACGAGTATGT
ACAGAAAGCCG -> CAGAAAGCCGT
ACAGAATAGAC -> CAGAATAGACC
ACAGAGCCCTG -> CAGAGCCCTGT
ACAGAGTGAGC -> CAGAGTGAGCT
ACAGCATCCTC -> CAGCATCCTCT
ACAGGCACCAA -> CAGGCACCAAG
ACAGGCAGATA -> CAGGCAGATAA
ACAGGTCGAGT -> CAGGTCGAGTG
ACAGTACGTAT -> CAGTACGTATC
ACAGTAGGCAG -> CAGTAGGCAGA
ACATACCATCT -> CATACCATCTT
ACATGACAACG -> CATGACAACGA
ACATTACAGTA -> CATTACAGTAC
ACATTGCCTTA -> CATTGCCTTAT
ACCAACCATTC -> CCAACCATTCC
ACCAAGCTAAT -> CCAAGCTAATG
ACCAGAGACGG -> CCAGAGACGGT
ACCAGCTCATC -> CCAGCTCATCG
ACCAGGCCGAT -> CCAGGCCGATA
ACCAGGTTTAA -> CCAGGTTTAAT
ACCAGTATGTC -> CCAGTATGTCC
ACCATCTTTAG -> CCATCTTTAGC
ACCATGGACAT -> CCATGGACATA
ACCATTCCAGG -> CCATTCCAGGG
ACCCCAATCGA -> CCCCAATCGAG
ACCCGGGTATT -> CCCGGGTATTA
ACCCGTCCATG -> CCCGTCCATGC
ACCCTAACCTA -> CCCTAACCTAT
ACCCTGACACA -> CCCTGACACAA
ACCGAAACGAA -> CCGAAACGAAG
ACCGAGCCATA -> CCGAGCCATAG
ACCGATAGCGA -> CCGATAGCGAT
ACCGCCCCCCC -> CCGCCCCCCCC
ACCGTGACCAG -> CCGTGACCAGC
ACCGTGGTGCT -> CCGTGGTGCTT
ACCGTTCGCCC -> CCGTTCGCCCC
ACCTATCGCGG -> CCTATCGCGGT
ACCTCTAGGAG -> CCTCTAGGAGC
ACCTCTTCCTA -> CCTCTTCCTAA
ACCTGGCAGCG -> CCTGGCAGCGT
ACGAACCTGGC -> CGAACCTGGCA
ACGAAGATCGT -> CGAAGATCGTA
ACGAAGTACAA -> CGAAGTACAAT
ACGACTACATT -> CGACTACATTA
ACGAGCTTCAC -> CGAGCTTCACC
ACGAGTATGTG -> CGAGTATGTGA
ACGATGGAGGA -> CGATGGAGGAC
ACGATGGCGTA -> CGATGGCGTAA
ACGCCAGATTG -> CGCCAGATTGA
ACGCGGTGATA -> CGCGGTGATAT
ACGCTCATTAG -> CGCTCATTAGG
ACGCTGTATGT -> CGCTGTATGTC
ACGGAAATCTC -> CGGAAATCTCT
ACGGACGTCCC -> CGGACGTCCCA
ACGGAGCATAA -> CGGAGCATAAT
ACGGAGGAATC -> CGGAGGAATCT
ACGGCCCAAAG -> CGGCCCAAAGC
ACGGCCGGGAA -> CGGCCGGGAAC
ACGGGAACTGC -> CGGGAACTGCG
ACGGGCGTCCG -> CGGGCGTCCGC
ACGGTCTTGCA -> CGGTCTTGCAT
ACGGTTTGAGT -> CGGTTTGAGTG
ACGTATCGCTG -> CGTATCGCTGG
ACGTCAGCTGT -> CGTCAGCTGTA
ACGTCCCATGT -> CGTCCCATGTA
ACGTCGTAGGC -> CGTCGTAGGCA
ACGTCTGATGC -> CGTCTGATGCG
ACGTGAGCCAA -> CGTGAGCCAAC
ACGTGCCCGGA -> CGTGCCCGGAG
ACGTGTCTCTT -> CGTGTCTCTTG
ACGTGTTGATG -> CGTGTTGATGG
ACGTTAACCAG -> CGTTAACCAGG
ACGTTCCAGGC -> CGTTCCAGGCG
ACGTTGGTACT -> CGTTGGTACTA
ACGTTTTCGAC -> CGTTTTCGACT
ACTACATTACA -> CTACATTACAG
ACTAGCGACCG -> CTAGCGACCGA
ACTAGCTGGTT -> CTAGCTGGTTG
ACTAGCTGTAG -> CTAGCTGTAGA
ACTATCATATT -> CTATCATATTT
ACTATTTAAGT -> CTATTTAAGTA
ACTCAGGCAGC -> CTCAGGCAGCG
ACTCCCAAACA -> CTCCCAAACAA
ACTCCTACATT -> CTCCTACATTG
ACTCCTGTCTG -> CTCCTGTCTGA
ACTCTCGAGGA -> CTCTCGAGGAG
ACTGAATCAAG -> CTGAATCAAGC
ACTGCAGCGCG -> CTGCAGCGCGG
ACTGCGACGGC -> CTGCGACGGCC
ACTGCGCGTAC -> CTGCGCGTACT
ACTGGGCTAAG -> CTGGGCTAAGT
ACTGGTGGTAC -> CTGGTGGTACA
ACTGTAGGCAG -> CTGTAGGCAGG
ACTGTCCACTA -> CTGTCCACTAG
ACTTAACCAGA -> CTTAACCAGAG
ACTTCAGTCAC -> CTTCAGTCACG
ACTTCAGTTCA -> CTTCAGTTCAG
AGAAACGTGTC -> GAAACGTGTCT
AGAAAGCCGTG -> GAAAGCCGTGG
AGAAATGACCA -> GAAATGACCAA
AGAACGTGTTG -> GAACGTGTTGA
AGAAGTCAAAA -> GAAGTCAAAAA
AGAAGTGAAGC -> GAAGTGAAGCG
AGAATAGACCG -> GAATAGACCGA
AGAATCTGATA -> GAATCTGATAA
AGACAATTCAG -> GACAATTCAGC
AGACAATTCCG -> GACAATTCCGA
AGACCAGTATG -> GACCAGTATGT
AGACCGAAACG -> GACCGAAACGA
AGACGGGCGTC -> GACGGGCGTCC
AGACGGTCTTG -> GACGGTCTTGC
AGACGTTAACC -> GACGTTAACCA
AGAGACGGTCT -> GAGACGGTCTT
AGAGCATGAAG -> GAGCATGAAGA
AGAGCCCTGTT -> GAGCCCTGTTA
AGAGCCTCTAA -> GAGCCTCTAAG
AGAGGCCCGAG -> GAGGCCCGAGC
AGAGGGCCAGA -> GAGGGCCAGAG
AGAGGTTCTCA -> GAGGTTCTCAC
AGAGTGAGCTG -> GAGTGAGCTGA
AGATAAATGTA -> GATAAATGTAA
AGATAACATGA -> GATAACATGAC
AGATAATAACG -> GATAATAACGT
AGATATACAAT -> GATATACAATG
AGATATTTACG -> GATATTTACGT
AGATCGTACAG -> GATCGTACAGG
AGATCGTTAAA -> GATCGTTAAAC
AGATCTTACCA -> GATCTTACCAG
AGATGTTTCTT -> GATGTTTCTTA
AGATTGAGAGG -> GATTGAGAGGG
AGATTGATACG -> GATTGATACGT
AGATTTATGGA -> GATTTATGGAA
AGCAACTTAAC -> GCAACTTAACC
AGCAAGATAAT -> GCAAGATAATA
AGCACGTTTTC -> GCACGTTTTCG
AGCAGGAGTCC -> GCAGGAGTCCA
AGCATAATCAC -> GCATAATCACC
AGCATCCTCTC -> GCATCCTCTCG
AGCATGAAGAC -> GCATGAAGACC
AGCCAACCGCC -> GCCAACCGCCC
AGCCAAGTCCA -> GCCAAGTCCAC
AGCCAGCACGT -> GCCAGCACGTT
AGCCAGGCGTC -> GCCAGGCGTCA
AGCCAGTGGCG -> GCCAGTGGCGC
AGCCATAGCCG -> GCCATAGCCGC
AGCCATGGTGT -> GCCATGGTGTT
AGCCCATGACT -> GCCCATGACTG
AGCCCGAAAGT -> GCCCGAAAGTT
AGCCCTAGGAT -> GCCCTAGGATG
AGCCCTGTTAA -> GCCCTGTTAAC
AGCCGCCTGAC -> GCCGCCTGACC
AGCCGTGGTCG -> GCCGTGGTCGA
AGCCTCAACGT -> GCCTCAACGTG
AGCCTCGGGTT -> GCCTCGGGTTC
AGCCTCTAAGC -> GCCTCTAAGCC
AGCCTTTTTTA -> GCCTTTTTTAC
AGCGACCGATA -> GCGACCGATAG
AGCGATACTTC -> GCGATACTTCA
AGCGCGGAGCT -> GCGCGGAGCTG
AGCGGTACGGG -> GCGGTACGGGA
AGCGTAGATGT -> GCGTAGATGTT
AGCGTGGGAGC -> GCGTGGGAGCC
AGCGTTACCGT -> GCGTTACCGTG
AGCTAATGTCG -> GCTAATGTCGC
AGCTAGCCTTT -> GCTAGCCTTTT
AGCTCATCGGG -> GCTCATCGGGA
AGCTCGTCCTG -> GCTCGTCCTGC
AGCTCTCAATC -> GCTCTCAATCT
AGCTGAACGCT -> GCTGAACGCTC
AGCTGAATACC -> GCTGAATACCC
AGCTGGAACCC -> GCTGGAACCCT
AGCTGGTTGCA -> GCTGGTTGCAC
AGCTGTAGAGC -> GCTGTAGAGCC
AGCTGTATCTC -> GCTGTATCTCT
AGCTTCACCCG -> GCTTCACCCGG
AGGAAAATATG -> GGAAAATATGG
AGGAAATTTCG -> GGAAATTTCGT
AGGAATCTACA -> GGAATCTACAC
AGGACTAGCTG -> GGACTAGCTGT
AGGACTGGTGG -> GGACTGGTGGT
AGGACTTCAGT -> GGACTTCAGTT
AGGAGAACGTG -> GGAGAACGTGT
AGGAGCTCTCA -> GGAGCTCTCAA
AGGAGTCCAGT -> GGAGTCCAGTT
AGGATGCTGAA -> GGATGCTGAAA
AGGATGTCTCA -> GGATGTCTCAT
AGGATTAGATT -> GGATTAGATTG
AGGCAATGAGT -> GGCAATGAGTG
AGGCACCAAGC -> GGCACCAAGCT
AGGCAGACAAT -> GGCAGACAATT
AGGCAGATAAA -> GGCAGATAAAT
AGGCAGCGTTA -> GGCAGCGTTAC
AGGCAGGTATC -> GGCAGGTATCC
AGGCAGTTTGT -> GGCAGTTTGTC
AGGCCCGAGCT -> GGCCCGAGCTA
AGGCCGATACA -> GGCCGATACAG
AGGCGTAGTAT -> GGCGTAGTATA
AGGCGTCAGGT -> GGCGTCAGGTA
AGGCGTGAATA -> GGCGTGAATAG
AGGGAGGGGGG -> GGGAGGGGGGT
AGGGCCAGAGG -> GGGCCAGAGGC
AGGGGGCAGGA -> GGGGGCAGGAA
AGGGGGCATAT -> GGGGGCATATG
AGGGGGGTTCT -> GGGGGGTTCTG
AGGTACACAAG -> GGTACACAAGC
AGGTATCCCAC -> GGTATCCCACG
AGGTATGGCGG -> GGTATGGCGGG
AGGTATGGTTG -> GGTATGGTTGC
AGGTATTAGAG -> GGTATTAGAGC
AGGTCGAGTGC -> GGTCGAGTGCC
AGGTTCTCACT -> GGTTCTCACTG
AGGTTTAATCG -> GGTTTAATCGA
AGTACAATTAA -> GTACAATTAAT
AGTACGTATCG -> GTACGTATCGC
AGTAGCAGGAG -> GTAGCAGGAGT
AGTAGGAAATT -> GTAGGAAATTT
AGTAGGCAGAC -> GTAGGCAGACA
AGTAGGTATGG -> GTAGGTATGGC
AGTAGTAGTGC -> GTAGTAGTGCG
AGTAGTGCGAA -> GTAGTGCGAAC
AGTATAACGAT -> GTATAACGATG
AGTATGTCCTG -> GTATGTCCTGA
AGTATGTGACT -> GTATGTGACTC
AGTCAAAAATC -> GTCAAAAATCG
AGTCACGAACC -> GTCACGAACCT
AGTCCACGAGC -> GTCCACGAGCT
AGTCCACTGTC -> GTCCACTGTCC
AGTCCAGTTTA -> GTCCAGTTTAG
AGTCCGCTTCC -> GTCCGCTTCCC
AGTCGTGTTTA -> GTCGTGTTTAG
AGTCTCTGACA -> GTCTCTGACAA
AGTCTGTTGAG -> GTCTGTTGAGC
AGTGAAGCGGT -> GTGAAGCGGTA
AGTGACGGAAA -> GTGACGGAAAT
AGTGAGCTGAA -> GTGAGCTGAAC
AGTGCAGTGTT -> GTGCAGTGTTG
AGTGCCTCAGA -> GTGCCTCAGAC
AGTGCGAACGG -> GTGCGAACGGT
AGTGGCACGCG -> GTGGCACGCGG
AGTGGCGCCTA -> GTGGCGCCTAA
AGTGGTCTGAG -> GTGGTCTGAGT
AGTGTTGAAAG -> GTGTTGAAAGA
AGTTATTCTTA -> GTTATTCTTAG
AGTTCACAGAG -> GTTCACAGAGC
AGTTCAGTAGG -> GTTCAGTAGGA
AGTTCGTCGTT -> GTTCGTCGTTT
AGTTTAGAAAT -> GTTTAGAAATG
AGTTTGTCCAT -> GTTTGTCCATG
ATAAATGTAAA -> TAAATGTAAAG
ATAACATGACA -> TAACATGACAA
ATAACCCCAAT -> TAACCCCAATC
ATAACGATGGA -> TAACGATGGAG
ATAACGTGCCC -> TAACGTGCCCG
ATAACTATCAT -> TAACTATCATA
ATAATAACGTG -> TAATAACGTGC
ATAATCACCGT -> TAATCACCGTT
ATACAATGTAC -> TACAATGTACG
ATACAGCATCC -> TACAGCATCCT
ATACCATCTTT -> TACCATCTTTA
ATACCCGTCCA -> TACCCGTCCAT
ATACCCTGACA -> TACCCTGACAC
ATACGAAGTAC -> TACGAAGTACA
ATACGTTGGTA -> TACGTTGGTAC
ATACTGTAGGC -> TACTGTAGGCA
ATACTTCAGTC -> TACTTCAGTCA
ATAGACCGAAA -> TAGACCGAAAC
ATAGATATACA -> TAGATATACAA
ATAGATCGTTA -> TAGATCGTTAA
ATAGCCGCCTG -> TAGCCGCCTGA
ATAGCGATACT -> TAGCGATACTT
ATAGGACTTCA -> TAGGACTTCAG
ATATACAATGT -> TATACAATGTA
ATATAGATATA -> TATAGATATAC
ATATCATCGGT -> TATCATCGGTA
ATATGCCGCTA -> TATGCCGCTAA
ATATGCGCTTG -> TATGCGCTTGA
ATATGGGGCAA -> TATGGGGCAAG
ATATTTACGTC -> TATTTACGTCA
ATATTTCTTAG -> TATTTCTTAGA
ATCAAGCCAGT -> TCAAGCCAGTG
ATCACCGTTCG -> TCACCGTTCGC
ATCAGGCGTGA -> TCAGGCGTGAA
ATCAGTCGTGT -> TCAGTCGTGTT
ATCATATTTCT -> TCATATTTCTT
ATCATCGGTAC -> TCATCGGTACG
ATCATGGTTTC -> TCATGGTTTCT
ATCCAAATCCT -> TCCAAATCCTT
ATCCCACGGAG -> TCCCACGGAGG
ATCCTCTCGGC -> TCCTCTCGGCC
ATCCTTGATAC -> TCCTTGATACT
ATCGAGACGTT -> TCGAGACGTTA
ATCGAGTGGCA -> TCGAGTGGCAC
ATCGCAGCCTC -> TCGCAGCCTCG
ATCGCGGTGTA -> TCGCGGTGTAG
ATCGCTGGGCC -> TCGCTGGGCCC
ATCGGCACAGG -> TCGGCACAGGC
ATCGGGACAAT -> TCGGGACAATT
ATCGGTACGTC -> TCGGTACGTCT
ATCGTACAGGC -> TCGTACAGGCA
ATCGTCACTGG -> TCGTCACTGGG
ATCGTTAAACG -> TCGTTAAACGT
ATCTACACGAG -> TCTACACGAGT
ATCTCTCCATA -> TCTCTCCATAC
ATCTCTCCTAA -> TCTCTCCTAAA
ATCTGATAACT -> TCTGATAACTA
ATCTTACCAGG -> TCTTACCAGGC
ATCTTCGATGC -> TCTTCGATGCC
ATCTTTAGCCC -> TCTTTAGCCCG
ATGAACAGAAA -> TGAACAGAAAG
ATGAAGAAACG -> TGAAGAAACGT
ATGAAGACCAG -> TGAAGACCAGT
ATGACAACGAC -> TGACAACGACT
ATGACCAACCA -> TGACCAACCAT
ATGACTGCAGC -> TGACTGCAGCG
ATGAGTGACGG -> TGAGTGACGGA
ATGATATCATC -> TGATATCATCG
ATGCAAATTAA -> TGCAAATTAAC
ATGCCAACGGA -> TGCCAACGGAC
ATGCCCGTCGG -> TGCCCGTCGGA
ATGCCGCTAAT -> TGCCGCTAATG
ATGCGCTATGC -> TGCGCTATGCA
ATGCGCTGTCG -> TGCGCTGTCGA
ATGCGCTTGAA -> TGCGCTTGAAA
ATGCTGAAAGA -> TGCTGAAAGAT
ATGGAACGCCA -> TGGAACGCCAG
ATGGAAGCTCG -> TGGAAGCTCGT
ATGGAATGATA -> TGGAATGATAT
ATGGACATACC -> TGGACATACCA
ATGGAGGACTG -> TGGAGGACTGG
ATGGATTGTCG -> TGGATTGTCGT
ATGGCGGGGCG -> TGGCGGGGCGG
ATGGCGTAAAT -> TGGCGTAAATT
ATGGGGCAAGT -> TGGGGCAAGTC
ATGGTGACAAA -> TGGTGACAAAG
ATGGTGTTGAT -> TGGTGTTGATT
ATGGTTGCACG -> TGGTTGCACGC
ATGGTTTCTGA -> TGGTTTCTGAG
ATGTAAAGCCC -> TGTAAAGCCCT
ATGTACAAGAA -> TGTACAAGAAG
ATGTACGTCGT -> TGTACGTCGTA
ATGTCCGAGAT -> TGTCCGAGATT
ATGTCCTGATA -> TGTCCTGATAC
ATGTCGCCGGT -> TGTCGCCGGTT
ATGTCTCATAA -> TGTCTCATAAC
ATGTGAACTCC -> TGTGAACTCCT
ATGTGACTCAG -> TGTGACTCAGG
ATGTTTCTTAG -> TGTTTCTTAGC
ATTAACTAGCT -> TTAACTAGCTG
ATTAAGTCCAC -> TTAAGTCCACT
ATTAATTGCAC -> TTAATTGCACA
ATTACAGTACG -> TTACAGTACGT
ATTAGAGCATG -> TTAGAGCATGA
ATTAGATTGAG -> TTAGATTGAGA
ATTAGGTATTA -> TTAGGTATTAG
ATTCAGCAACT -> TTCAGCAACTT
ATTCCAGGGGG -> TTCCAGGGGGC
ATTCCGAACTC -> TTCCGAACTCC
ATTCGCGCTGC -> TTCGCGCTGCG
ATTCTTAGGGA -> TTCTTAGGGAG
ATTGAGAGGGC -> TTGAGAGGGCC
ATTGAGGGGGC -> TTGAGGGGGCA
ATTGATACGTT -> TTGATACGTTG
ATTGCACAGGT -> TTGCACAGGTC
ATTGCCTTATC -> TTGCCTTATCA
ATTGGATTCGC -> TTGGATTCGCG
ATTGGCCGTCA -> TTGGCCGTCAT
ATTGTCGTACG -> TTGTCGTACGG
ATTGTGAGGAC -> TTGTGAGGACT
ATTTAAGTAGT -> TTTAAGTAGTA
ATTTACGTCAG -> TTTACGTCAGC
ATTTATGGAAC -> TTTATGGAACG
ATTTCGTCCCT -> TTTCGTCCCTG
ATTTCTTAGAG -> TTTCTTAGAGG
CAAAAATCGGC -> AAAAATCGGCA
CAAAAGTCCGC -> AAAAGTCCGCT
CAAACAACCTC -> AAACAACCTCT
CAAAGCCTCAA -> AAAGCCTCAAC
CAAAGTGGTCT -> AAAGTGGTCTG
CAAATCCTTGA -> AAATCCTTGAT
CAAATTAACTA -> AAATTAACTAG
CAACCATTCCA -> AACCATTCCAG
CAACCGCCCCC -> AACCGCCCCCC
CAACCTCTAGG -> AACCTCTAGGA
CAACGACTACA -> AACGACTACAT
CAACGGACGTC -> AACGGACGTCC
CAACGTGAGCC -> AACGTGAGCCA
CAACTTAACCA -> AACTTAACCAG
CAAGAAGTGAA -> AAGAAGTGAAG
CAAGATAATAA -> AAGATAATAAC
CAAGCCAGTGG -> AAGCCAGTGGC
CAAGCTAATGT -> AAGCTAATGTC
CAAGCTGGAAC -> AAGCTGGAACC
CAAGGTACACA -> AAGGTACACAA
CAAGTCCACGA -> AAGTCCACGAG
CAAGTCTGTTG -> AAGTCTGTTGA
CAATCGAGACG -> AATCGAGACGT
CAATCGTCACT -> AATCGTCACTG
CAATCTTCGAT -> AATCTTCGATG
CAATGAGTGAC -> AATGAGTGACG
CAATGTACGTC -> AATGTACGTCG
CAATTAATTGC -> AATTAATTGCA
CAATTCAGCAA -> AATTCAGCAAC
CAATTCCGAAC -> AATTCCGAACT
CAATTGTGAGG -> AATTGTGAGGA
CACAAAAGTCC -> ACAAAAGTCCG
CACAAGCTGGA -> ACAAGCTGGAA
CACAGAATAGA -> ACAGAATAGAC
CACAGAGCCCT -> ACAGAGCCCTG
CACAGGCAGAT -> ACAGGCAGATA
CACAGGTCGAG -> ACAGGTCGAGT
CACCAAGCTAA -> ACCAAGCTAAT
CACCCGGGTAT -> ACCCGGGTATT
CACCGAGCCAT -> ACCGAGCCATA
CACCGTTCGCC -> ACCGTTCGCCC
CACGAACCTGG -> ACGAACCTGGC
CACGAGCTTCA -> ACGAGCTTCAC
CACGAGTATGT -> ACGAGTATGTG
CACGCGGTGAT -> ACGCGGTGATA
CACGCTGTATG -> ACGCTGTATGT
CACGGAGGAAT -> ACGGAGGAATC
CACGTTTTCGA -> ACGTTTTCGAC
CACTAGCGACC -> ACTAGCGACCG
CACTGCGCGTA -> ACTGCGCGTAC
CACTGGGCTAA -> ACTGGGCTAAG
CACTGTCCACT -> ACTGTCCACTA
CAGAAAGCCGT -> AGAAAGCCGTG
CAGAATAGACC -> AGAATAGACCG
CAGACAATTCC -> AGACAATTCCG
CAGACGGGCGT -> AGACGGGCGTC
CAGAGACGGTC -> AGAGACGGTCT
CAGAGCCCTGT -> AGAGCCCTGTT
CAGAGGCCCGA -> AGAGGCCCGAG
CAGAGTGAGCT -> AGAGTGAGCTG
CAGATAAATGT -> AGATAAATGTA
CAGATTGATAC -> AGATTGATACG
CAGCAACTTAA -> AGCAACTTAAC
CAGCACGTTTT -> AGCACGTTTTC
CAGCATCCTCT -> AGCATCCTCTC
CAGCCTCGGGT -> AGCCTCGGGTT
CAGCGCGGAGC -> AGCGCGGAGCT
CAGCGTAGATG -> AGCGTAGATGT
CAGCGTTACCG -> AGCGTTACCGT
CAGCTCATCGG -> AGCTCATCGGG
CAGCTGTATCT -> AGCTGTATCTC
CAGGAAAATAT -> AGGAAAATATG
CAGGAGTCCAG -> AGGAGTCCAGT
CAGGCACCAAG -> AGGCACCAAGC
CAGGCAGATAA -> AGGCAGATAAA
CAGGCAGCGTT -> AGGCAGCGTTA
CAGGCCGATAC -> AGGCCGATACA
CAGGCGTAGTA -> AGGCGTAGTAT
CAGGCGTCAGG -> AGGCGTCAGGT
CAGGCGTGAAT -> AGGCGTGAATA
CAGGGGGCAGG -> AGGGGGCAGGA
CAGGTATCCCA -> AGGTATCCCAC
CAGGTATGGTT -> AGGTATGGTTG
CAGGTCGAGTG -> AGGTCGAGTGC
CAGGTTTAATC -> AGGTTTAATCG
CAGTACGTATC -> AGTACGTATCG
CAGTAGGAAAT -> AGTAGGAAATT
CAGTAGGCAGA -> AGTAGGCAGAC
CAGTATGTCCT -> AGTATGTCCTG
CAGTCACGAAC -> AGTCACGAACC
CAGTCGTGTTT -> AGTCGTGTTTA
CAGTGGCGCCT -> AGTGGCGCCTA
CAGTGTTGAAA -> AGTGTTGAAAG
CAGTTCAGTAG -> AGTTCAGTAGG
CAGTTTAGAAA -> AGTTTAGAAAT
CAGTTTGTCCA -> AGTTTGTCCAT
CATAACCCCAA -> ATAACCCCAAT
CATAATCACCG -> ATAATCACCGT
CATACCATCTT -> ATACCATCTTT
CATACCCTGAC -> ATACCCTGACA
CATAGATCGTT -> ATAGATCGTTA
CATAGCCGCCT -> ATAGCCGCCTG
CATATAGATAT -> ATATAGATATA
CATATGCCGCT -> ATATGCCGCTA
CATATTTCTTA -> ATATTTCTTAG
CATCCAAATCC -> ATCCAAATCCT
CATCCTCTCGG -> ATCCTCTCGGC
CATCGGGACAA -> ATCGGGACAAT
CATCGGTACGT -> ATCGGTACGTC
CATCTTTAGCC -> ATCTTTAGCCC
CATGAAGACCA -> ATGAAGACCAG
CATGACAACGA -> ATGACAACGAC
CATGACTGCAG -> ATGACTGCAGC
CATGCCAACGG -> ATGCCAACGGA
CATGGACATAC -> ATGGACATACC
CATGGTGACAA -> ATGGTGACAAA
CATGGTGTTGA -> ATGGTGTTGAT
CATGGTTTCTG -> ATGGTTTCTGA
CATGTACAAGA -> ATGTACAAGAA
CATGTGAACTC -> ATGTGAACTCC
CATTACAGTAC -> ATTACAGTACG
CATTAGGTATT -> ATTAGGTATTA
CATTCCAGGGG -> ATTCCAGGGGG
CATTGCCTTAT -> ATTGCCTTATC
CCAAACAACCT -> CAAACAACCTC
CCAAAGCCTCA -> CAAAGCCTCAA
CCAAATCCTTG -> CAAATCCTTGA
CCAACCATTCC -> CAACCATTCCA
CCAACCGCCCC -> CAACCGCCCCC
CCAACGGACGT -> CAACGGACGTC
CCAAGCTAATG -> CAAGCTAATGT
CCAAGGTACAC -> CAAGGTACACA
CCAAGTCCACG -> CAAGTCCACGA
CCAATCGAGAC -> CAATCGAGACG
CCACCGAGCCA -> CACCGAGCCAT
CCACGAGCTTC -> CACGAGCTTCA
CCACGGAGGAA -> CACGGAGGAAT
CCACTAGCGAC -> CACTAGCGACC
CCACTGTCCAC -> CACTGTCCACT
CCAGAGACGGT -> CAGAGACGGTC
CCAGAGGCCCG -> CAGAGGCCCGA
CCAGATTGATA -> CAGATTGATAC
CCAGCACGTTT -> CAGCACGTTTT
CCAGCTCATCG -> CAGCTCATCGG
CCAGGCCGATA -> CAGGCCGATAC
CCAGGCGTAGT -> CAGGCGTAGTA
CCAGGCGTCAG -> CAGGCGTCAGG
CCAGGGGGCAG -> CAGGGGGCAGG
CCAGGTTTAAT -> CAGGTTTAATC
CCAGTATGTCC -> CAGTATGTCCT
CCAGTGGCGCC -> CAGTGGCGCCT
CCAGTTTAGAA -> CAGTTTAGAAA
CCATACCCTGA -> CATACCCTGAC
CCATAGCCGCC -> CATAGCCGCCT
CCATCTTTAGC -> CATCTTTAGCC
CCATGACTGCA -> CATGACTGCAG
CCATGCCAACG -> CATGCCAACGG
CCATGGACATA -> CATGGACATAC
CCATGGTGACA -> CATGGTGACAA
CCATGGTGTTG -> CATGGTGTTGA
CCATGTACAAG -> CATGTACAAGA
CCATGTGAACT -> CATGTGAACTC
CCATTCCAGGG -> CATTCCAGGGG
CCCAAACAACC -> CCAAACAACCT
CCCAAAGCCTC -> CCAAAGCCTCA
CCCAAGGTACA -> CCAAGGTACAC
CCCAATCGAGA -> CCAATCGAGAC
CCCACCGAGCC -> CCACCGAGCCA
CCCACGGAGGA -> CCACGGAGGAA
CCCATGACTGC -> CCATGACTGCA
CCCATGTACAA -> CCATGTACAAG
CCCCAAGGTAC -> CCCAAGGTACA
CCCCAATCGAG -> CCCAATCGAGA
CCCCCAAGGTA -> CCCCAAGGTAC
CCCCCCAAGGT -> CCCCCAAGGTA
CCCCCCCAAGG -> CCCCCCAAGGT
CCCCCCCCAAG -> CCCCCCCAAGG
CCCCGGTAGCA -> CCCGGTAGCAT
CCCCGTAAGCG -> CCCGTAAGCGT
CCCGAAAGTTC -> CCGAAAGTTCG
CCCGAGCTAGC -> CCGAGCTAGCC
CCCGGAGATCT -> CCGGAGATCTT
CCCGGGTACAG -> CCGGGTACAGA
CCCGGGTATTA -> CCGGGTATTAA
CCCGGTAGCAT -> CCGGTAGCATA
CCCGTAAGCGT -> CCGTAAGCGTG
CCCGTCCATGC -> CCGTCCATGCC
CCCGTCGGACG -> CCGTCGGACGA
CCCTAACCTAT -> CCTAACCTATC
CCCTAGGATGT -> CCTAGGATGTC
CCCTGACACAA -> CCTGACACAAA
CCCTGTGGGCG -> CCTGTGGGCGA
CCCTGTTAACG -> CCTGTTAACGG
CCGAAACGAAG -> CGAAACGAAGA
CCGAAAGTTCG -> CGAAAGTTCGT
CCGAACTCCCA -> CGAACTCCCAA
CCGAGATTTAT -> CGAGATTTATG
CCGAGCCATAG -> CGAGCCATAGC
CCGAGCTAGCC -> CGAGCTAGCCT
CCGAGGCAATG -> CGAGGCAATGA
CCGATACAGCA -> CGATACAGCAT
CCGATAGCGAT -> CGATAGCGATA
CCGCCATGTGA -> CGCCATGTGAA
CCGCCCCCCCC -> CGCCCCCCCCA
CCGCCTGACCT -> CGCCTGACCTC
CCGCTAATGGA -> CGCTAATGGAT
CCGCTTCCCCG -> CGCTTCCCCGG
CCGGAGATCTT -> CGGAGATCTTA
CCGGGAACCAT -> CGGGAACCATG
CCGGGTACAGA -> CGGGTACAGAG
CCGGGTATTAA -> CGGGTATTAAG
CCGGTAGCATA -> CGGTAGCATAC
CCGGTTCTGAG -> CGGTTCTGAGC
CCGTAAGCGTG -> CGTAAGCGTGG
CCGTCATAGAT -> CGTCATAGATC
CCGTCCATGCC -> CGTCCATGCCA
CCGTCGGACGA -> CGTCGGACGAT
CCGTGACCAGC -> CGTGACCAGCT
CCGTGGTCGAT -> CGTGGTCGATC
CCGTGGTGCTT -> CGTGGTGCTTC
CCGTTCGCCCC -> CGTTCGCCCCG
CCTAAAAGCAA -> CTAAAAGCAAG
CCTAAAGGATT -> CTAAAGGATTA
CCTAACCTATC -> CTAACCTATCG
CCTAATCGCAG -> CTAATCGCAGC
CCTACATTGCC -> CTACATTGCCT
CCTAGGATGTC -> CTAGGATGTCT
CCTATCGCGGT -> CTATCGCGGTG
CCTCAACGTGA -> CTCAACGTGAG
CCTCAGACGGG -> CTCAGACGGGC
CCTCGGGTTCC -> CTCGGGTTCCG
CCTCTAAGCCA -> CTCTAAGCCAA
CCTCTAGGAGC -> CTCTAGGAGCT
CCTCTCGGCCC -> CTCTCGGCCCG
CCTCTTCCTAA -> CTCTTCCTAAA
CCTGACACAAA -> CTGACACAAAA
CCTGACCTCTT -> CTGACCTCTTC
CCTGATACGAA -> CTGATACGAAG
CCTGCGGATGA -> CTGCGGATGAA
CCTGGCAGCGT -> CTGGCAGCGTA
CCTGTCTGATG -> CTGTCTGATGC
CCTGTGGGCGA -> CTGTGGGCGAG
CCTGTTAACGG -> CTGTTAACGGA
CCTTATCATGG -> CTTATCATGGT
CCTTGATACTG -> CTTGATACTGT
CCTTTTTTACT -> CTTTTTTACTC
CGAAACGAAGA -> GAAACGAAGAT
CGAAAGTTCGT -> GAAAGTTCGTC
CGAACCTGGCA -> GAACCTGGCAG
CGAACGGTTTG -> GAACGGTTTGA
CGAACTCCCAA -> GAACTCCCAAA
CGAAGATCGTA -> GAAGATCGTAC
CGAAGTACAAT -> GAAGTACAATT
CGAATGAACAG -> GAATGAACAGA
CGACCGATAGC -> GACCGATAGCG
CGACGGCCGGG -> GACGGCCGGGA
CGACTACATTA -> GACTACATTAC
CGACTCCTGTC -> GACTCCTGTCT
CGAGACGTTAA -> GAGACGTTAAC
CGAGATTTATG -> GAGATTTATGG
CGAGCCATAGC -> GAGCCATAGCC
CGAGCTAGCCT -> GAGCTAGCCTT
CGAGCTTCACC -> GAGCTTCACCC
CGAGGAGAACG -> GAGGAGAACGT
CGAGGATGCTG -> GAGGATGCTGA
CGAGGCAATGA -> GAGGCAATGAG
CGAGTATGTGA -> GAGTATGTGAC
CGAGTGCCTCA -> GAGTGCCTCAG
CGAGTGGCACG -> GAGTGGCACGC
CGATACAGCAT -> GATACAGCATC
CGATACTTCAG -> GATACTTCAGT
CGATAGCGATA -> GATAGCGATAC
CGATCAGTCGT -> GATCAGTCGTG
CGATGCCCGTC -> GATGCCCGTCG
CGATGGAGGAC -> GATGGAGGACT
CGATGGCGTAA -> GATGGCGTAAA
CGCAGCCTCGG -> GCAGCCTCGGG
CGCCAGATTGA -> GCCAGATTGAT
CGCCATGTGAA -> GCCATGTGAAC
CGCCCCCCCCA -> GCCCCCCCCAA
CGCCCCGTAAG -> GCCCCGTAAGC
CGCCGGTTCTG -> GCCGGTTCTGA
CGCCTAATCGC -> GCCTAATCGCA
CGCCTGACCTC -> GCCTGACCTCT
CGCGCTGCGGT -> GCGCTGCGGTT
CGCGGAGCTGA -> GCGGAGCTGAA
CGCGGTGATAT -> GCGGTGATATG
CGCGGTGTAGT -> GCGGTGTAGTT
CGCGTACTGAA -> GCGTACTGAAT
CGCTAATGGAT -> GCTAATGGATT
CGCTATGCAAA -> GCTATGCAAAT
CGCTCATTAGG -> GCTCATTAGGT
CGCTGCGGTTC -> GCTGCGGTTCT
CGCTGGGCCCA -> GCTGGGCCCAC
CGCTGTATGTC -> GCTGTATGTCC
CGCTGTCGAAT -> GCTGTCGAATG
CGCTTCCCCGG -> GCTTCCCCGGT
CGCTTGAAAGA -> GCTTGAAAGAT
CGGAAATCTCT -> GGAAATCTCTC
CGGACGATGGC -> GGACGATGGCG
CGGACGTCCCA -> GGACGTCCCAT
CGGAGATCTTA -> GGAGATCTTAC
CGGAGCATAAT -> GGAGCATAATC
CGGAGCTGAAT -> GGAGCTGAATA
CGGAGGAATCT -> GGAGGAATCTA
CGGATGAAGAA -> GGATGAAGAAA
CGGCACAGGCA -> GGCACAGGCAG
CGGCCCAAAGC -> GGCCCAAAGCC
CGGCCCGGGTA -> GGCCCGGGTAC
CGGCCGGGAAC -> GGCCGGGAACC
CGGGAACCATG -> GGGAACCATGG
CGGGAACTGCG -> GGGAACTGCGA
CGGGACAATTG -> GGGACAATTGT
CGGGCGTCCGC -> GGGCGTCCGCC
CGGGGCGGTTG -> GGGGCGGTTGA
CGGGTACAGAG -> GGGTACAGAGT
CGGGTATTAAG -> GGGTATTAAGT
CGGGTTCCGAG -> GGGTTCCGAGG
CGGTACGGGAA -> GGTACGGGAAC
CGGTACGTCTG -> GGTACGTCTGA
CGGTAGCATAC -> GGTAGCATACA
CGGTCTTGCAT -> GGTCTTGCATC
CGGTGATATGC -> GGTGATATGCG
CGGTGTAGTTC -> GGTGTAGTTCA
CGGTTCTGAGC -> GGTTCTGAGCC
CGGTTCTTATG -> GGTTCTTATGG
CGGTTGAGACA -> GGTTGAGACAA
CGGTTTGAGTG -> GGTTTGAGTGC
CGTAAATTGAG -> GTAAATTGAGG
CGTAAGCGTGG -> GTAAGCGTGGG
CGTACAGGCAC -> GTACAGGCACC
CGTACGGCCCA -> GTACGGCCCAA
CGTACTGAATC -> GTACTGAATCA
CGTAGATGTTT -> GTAGATGTTTC
CGTAGGCAGTT -> GTAGGCAGTTT
CGTAGTATAAC -> GTAGTATAACG
CGTATCGCTGG -> GTATCGCTGGG
CGTCACTGGGC -> GTCACTGGGCT
CGTCAGCTGTA -> GTCAGCTGTAT
CGTCAGGTATG -> GTCAGGTATGG
CGTCATAGATC -> GTCATAGATCG
CGTCATATAGA -> GTCATATAGAT
CGTCCATGCCA -> GTCCATGCCAA
CGTCCCATGTA -> GTCCCATGTAC
CGTCCCTGTGG -> GTCCCTGTGGG
CGTCCGCCATG -> GTCCGCCATGT
CGTCCTGCGGA -> GTCCTGCGGAT
CGTCGGACGAT -> GTCGGACGATG
CGTCGTAGGCA -> GTCGTAGGCAG
CGTCGTTTATT -> GTCGTTTATTG
CGTCTGATGCG -> GTCTGATGCGC
CGTGAATAGGA -> GTGAATAGGAC
CGTGACCAGCT -> GTGACCAGCTC
CGTGAGAAGTC -> GTGAGAAGTCA
CGTGAGCCAAC -> GTGAGCCAACC
CGTGCCCGGAG -> GTGCCCGGAGA
CGTGGGAGCCA -> GTGGGAGCCAG
CGTGGTCGATC -> GTGGTCGATCA
CGTGGTGCTTC -> GTGGTGCTTCG
CGTGTCTCTTG -> GTGTCTCTTGA
CGTGTTGATGG -> GTGTTGATGGA
CGTGTTTAGTT -> GTGTTTAGTTA
CGTTAAACGTT -> GTTAAACGTTC
CGTTAACCAGG -> GTTAACCAGGT
CGTTACCGTGG -> GTTACCGTGGT
CGTTCCAGGCG -> GTTCCAGGCGT
CGTTCGCCCCG -> GTTCGCCCCGT
CGTTGGTACTA -> GTTGGTACTAT
CGTTTATTGGA -> GTTTATTGGAT
CGTTTTCGACT -> GTTTTCGACTC
CTAAAAGCAAG -> TAAAAGCAAGA
CTAAAGGATTA -> TAAAGGATTAG
CTAACCTATCG -> TAACCTATCGC
CTAAGCCAAGT -> TAAGCCAAGTC
CTAAGTAGGTA -> TAAGTAGGTAT
CTAATCGCAGC -> TAATCGCAGCC
CTAATGGATTG -> TAATGGATTGT
CTAATGTCGCC -> TAATGTCGCCG
CTACACGAGTA -> TACACGAGTAT
CTACATTACAG -> TACATTACAGT
CTACATTGCCT -> TACATTGCCTT
CTAGCCTTTTT -> TAGCCTTTTTT
CTAGCGACCGA -> TAGCGACCGAT
CTAGCTGGTTG -> TAGCTGGTTGC
CTAGCTGTAGA -> TAGCTGTAGAG
CTAGGAGCTCT -> TAGGAGCTCTC
CTAGGATGTCT -> TAGGATGTCTC
CTATCATATTT -> TATCATATTTC
CTATCGCGGTG -> TATCGCGGTGT
CTATGCAAATT -> TATGCAAATTA
CTATTTAAGTA -> TATTTAAGTAG
CTCAACGTGAG -> TCAACGTGAGC
CTCAATCTTCG -> TCAATCTTCGA
CTCACTGCGCG -> TCACTGCGCGT
CTCAGACGGGC -> TCAGACGGGCG
CTCAGGCAGCG -> TCAGGCAGCGT
CTCATAACCCC -> TCATAACCCCA
CTCATCGGGAC -> TCATCGGGACA
CTCATTAGGTA -> TCATTAGGTAT
CTCCATACCCT -> TCCATACCCTG
CTCCCAAACAA -> TCCCAAACAAC
CTCCTAAAGGA -> TCCTAAAGGAT
CTCCTACATTG -> TCCTACATTGC
CTCCTGTCTGA -> TCCTGTCTGAT
CTCGAGGAGAA -> TCGAGGAGAAC
CTCGGCCCGGG -> TCGGCCCGGGT
CTCGGGTTCCG -> TCGGGTTCCGA
CTCGTCCTGCG -> TCGTCCTGCGG
CTCTAAGCCAA -> TCTAAGCCAAG
CTCTAGGAGCT -> TCTAGGAGCTC
CTCTCAATCTT -> TCTCAATCTTC
CTCTCCATACC -> TCTCCATACCC
CTCTCCTAAAG -> TCTCCTAAAGG
CTCTCGAGGAG -> TCTCGAGGAGA
CTCTCGGCCCG -> TCTCGGCCCGG
CTCTGACAATC -> TCTGACAATCG
CTCTTCCTAAA -> TCTTCCTAAAA
CTCTTGATCAG -> TCTTGATCAGG
CTGAAAGATAT -> TGAAAGATATT
CTGAACGCTCA -> TGAACGCTCAT
CTGAATACCCG -> TGAATACCCGT
CTGAATCAAGC -> TGAATCAAGCC
CTGACAATCGT -> TGACAATCGTC
CTGACACAAAA -> TGACACAAAAG
CTGACCTCTTC -> TGACCTCTTCC
CTGAGCCCATG -> TGAGCCCATGA
CTGAGTAGCAG -> TGAGTAGCAGG
CTGAGTCTCTG -> TGAGTCTCTGA
CTGATAACTAT -> TGATAACTATC
CTGATACGAAG -> TGATACGAAGT
CTGATGCGCTA -> TGATGCGCTAT
CTGATGCGCTG -> TGATGCGCTGT
CTGCAGCGCGG -> TGCAGCGCGGA
CTGCGACGGCC -> TGCGACGGCCG
CTGCGCGTACT -> TGCGCGTACTG
CTGCGGATGAA -> TGCGGATGAAG
CTGCGGTTCTT -> TGCGGTTCTTA
CTGGAACCCTA -> TGGAACCCTAA
CTGGCAGCGTA -> TGGCAGCGTAG
CTGGCTGGTCG -> TGGCTGGTCGT
CTGGGCCCACC -> TGGGCCCACCG
CTGGGCTAAGT -> TGGGCTAAGTA
CTGGTCGTGAG -> TGGTCGTGAGA
CTGGTGGTACA -> TGGTGGTACAG
CTGGTTGCACA -> TGGTTGCACAG
CTGTAGAGCCT -> TGTAGAGCCTC
CTGTAGGCAGG -> TGTAGGCAGGT
CTGTATCTCTC -> TGTATCTCTCC
CTGTATGTCCG -> TGTATGTCCGA
CTGTCCACTAG -> TGTCCACTAGC
CTGTCGAATGA -> TGTCGAATGAA
CTGTCTGATGC -> TGTCTGATGCG
CTGTGGGCGAG -> TGTGGGCGAGG
CTGTTAACGGA -> TGTTAACGGAG
CTGTTGAGCCA -> TGTTGAGCCAT
CTTAACCAGAG -> TTAACCAGAGA
CTTACCAGGCC -> TTACCAGGCCG
CTTAGAGGTTC -> TTAGAGGTTCT
CTTAGCCAGCA -> TTAGCCAGCAC
CTTAGGGAGGG -> TTAGGGAGGGG
CTTATCATGGT -> TTATCATGGTT
CTTATGGAAGC -> TTATGGAAGCT
CTTCACCCGGG -> TTCACCCGGGT
CTTCAGTCACG -> TTCAGTCACGA
CTTCAGTTCAG -> TTCAGTTCAGT
CTTCCCCGGTA -> TTCCCCGGTAG
CTTCCTAAAAG -> TTCCTAAAAGC
CTTCGATGCCC -> TTCGATGCCCG
CTTCGTCATAT -> TTCGTCATATA
CTTGAAAGATA -> TTGAAAGATAA
CTTGATACTGT -> TTGATACTGTA
CTTGATCAGGC -> TTGATCAGGCG
CTTGCATCCAA -> TTGCATCCAAA
CTTTAGCCCGA -> TTTAGCCCGAA
CTTTTTTACTC -> TTTTTTACTCT
GAAAATATGGG -> AAAATATGGGG
GAAACGAAGAT -> AAACGAAGATC
GAAACGTGTCT -> AAACGTGTCTC
GAAAGAATCTG -> AAAGAATCTGA
GAAAGATAACA -> AAAGATAACAT
GAAAGATATTT -> AAAGATATTTA
GAAAGCCGTGG -> AAAGCCGTGGT
GAAAGTTCGTC -> AAAGTTCGTCG
GAAATCTCTCC -> AAATCTCTCCA
GAAATGACCAA -> AAATGACCAAC
GAAATTTCGTC -> AAATTTCGTCC
GAACAGAAAGC -> AACAGAAAGCC
GAACCATGGAC -> AACCATGGACA
GAACCCTAACC -> AACCCTAACCT
GAACCTGGCAG -> AACCTGGCAGC
GAACGCCAGAT -> AACGCCAGATT
GAACGCTCATT -> AACGCTCATTA
GAACGGTTTGA -> AACGGTTTGAG
GAACGTGTTGA -> AACGTGTTGAT
GAACTCCCAAA -> AACTCCCAAAC
GAACTCCTACA -> AACTCCTACAT
GAACTGCGACG -> AACTGCGACGG
GAAGAAACGTG -> AAGAAACGTGT
GAAGACCAGTA -> AAGACCAGTAT
GAAGATCGTAC -> AAGATCGTACA
GAAGCGGTACG -> AAGCGGTACGG
GAAGCTCGTCC -> AAGCTCGTCCT
GAAGTACAATT -> AAGTACAATTA
GAAGTCAAAAA -> AAGTCAAAAAT
GAAGTGAAGCG -> AAGTGAAGCGG
GAATACCCGTC -> AATACCCGTCC
GAATAGACCGA -> AATAGACCGAA
GAATAGGACTT -> AATAGGACTTC
GAATCAAGCCA -> AATCAAGCCAG
GAATCTACACG -> AATCTACACGA
GAATCTGATAA -> AATCTGATAAC
GAATGAACAGA -> AATGAACAGAA
GAATGATATCA -> AATGATATCAT
GACAAAGTGGT -> ACAAAGTGGTC
GACAACGACTA -> ACAACGACTAC
GACAATCGTCA -> ACAATCGTCAC
GACAATTCAGC -> ACAATTCAGCA
GACAATTCCGA -> ACAATTCCGAA
GACAATTGTGA -> ACAATTGTGAG
GACACAAAAGT -> ACACAAAAGTC
GACATACCATC -> ACATACCATCT
GACCAACCATT -> ACCAACCATTC
GACCAGCTCAT -> ACCAGCTCATC
GACCAGTATGT -> ACCAGTATGTC
GACCGAAACGA -> ACCGAAACGAA
GACCGATAGCG -> ACCGATAGCGA
GACCTCTTCCT -> ACCTCTTCCTA
GACGATGGCGT -> ACGATGGCGTA
GACGGAAATCT -> ACGGAAATCTC
GACGGCCGGGA -> ACGGCCGGGAA
GACGGGCGTCC -> ACGGGCGTCCG
GACGGTCTTGC -> ACGGTCTTGCA
GACGTCCCATG -> ACGTCCCATGT
GACGTTAACCA -> ACGTTAACCAG
GACTACATTAC -> ACTACATTACA
GACTAGCTGTA -> ACTAGCTGTAG
GACTCAGGCAG -> ACTCAGGCAGC
GACTCCTGTCT -> ACTCCTGTCTG
GACTGCAGCGC -> ACTGCAGCGCG
GACTGGTGGTA -> ACTGGTGGTAC
GACTTCAGTTC -> ACTTCAGTTCA
GAGAACGTGTT -> AGAACGTGTTG
GAGAAGTCAAA -> AGAAGTCAAAA
GAGACAATTCA -> AGACAATTCAG
GAGACGGTCTT -> AGACGGTCTTG
GAGACGTTAAC -> AGACGTTAACC
GAGAGGGCCAG -> AGAGGGCCAGA
GAGATCTTACC -> AGATCTTACCA
GAGATTTATGG -> AGATTTATGGA
GAGCATAATCA -> AGCATAATCAC
GAGCATGAAGA -> AGCATGAAGAC
GAGCCAACCGC -> AGCCAACCGCC
GAGCCAGGCGT -> AGCCAGGCGTC
GAGCCATAGCC -> AGCCATAGCCG
GAGCCATGGTG -> AGCCATGGTGT
GAGCCCATGAC -> AGCCCATGACT
GAGCCCTGTTA -> AGCCCTGTTAA
GAGCCTCTAAG -> AGCCTCTAAGC
GAGCTAGCCTT -> AGCTAGCCTTT
GAGCTCTCAAT -> AGCTCTCAATC
GAGCTGAACGC -> AGCTGAACGCT
GAGCTGAATAC -> AGCTGAATACC
GAGCTTCACCC -> AGCTTCACCCG
GAGGAATCTAC -> AGGAATCTACA
GAGGACTAGCT -> AGGACTAGCTG
GAGGACTGGTG -> AGGACTGGTGG
GAGGAGAACGT -> AGGAGAACGTG
GAGGATGCTGA -> AGGATGCTGAA
GAGGCAATGAG -> AGGCAATGAGT
GAGGCCCGAGC -> AGGCCCGAGCT
GAGGGCCAGAG -> AGGGCCAGAGG
GAGGGGGCATA -> AGGGGGCATAT
GAGGGGGGTTC -> AGGGGGGTTCT
GAGGTTCTCAC -> AGGTTCTCACT
GAGTAGCAGGA -> AGTAGCAGGAG
GAGTATGTGAC -> AGTATGTGACT
GAGTCCAGTTT -> AGTCCAGTTTA
GAGTCTCTGAC -> AGTCTCTGACA
GAGTGACGGAA -> AGTGACGGAAA
GAGTGAGCTGA -> AGTGAGCTGAA
GAGTGCAGTGT -> AGTGCAGTGTT
GAGTGCCTCAG -> AGTGCCTCAGA
GAGTGGCACGC -> AGTGGCACGCG
GATAAATGTAA -> ATAAATGTAAA
GATAACATGAC -> ATAACATGACA
GATAACTATCA -> ATAACTATCAT
GATAATAACGT -> ATAATAACGTG
GATACAGCATC -> ATACAGCATCC
GATACGAAGTA -> ATACGAAGTAC
GATACGTTGGT -> ATACGTTGGTA
GATACTGTAGG -> ATACTGTAGGC
GATACTTCAGT -> ATACTTCAGTC
GATAGCGATAC -> ATAGCGATACT
GATATACAATG -> ATATACAATGT
GATATCATCGG -> ATATCATCGGT
GATATGCGCTT -> ATATGCGCTTG
GATATTTACGT -> ATATTTACGTC
GATCAGGCGTG -> ATCAGGCGTGA
GATCAGTCGTG -> ATCAGTCGTGT
GATCGTACAGG -> ATCGTACAGGC
GATCGTTAAAC -> ATCGTTAAACG
GATCTTACCAG -> ATCTTACCAGG
GATGAAGAAAC -> ATGAAGAAACG
GATGCCCGTCG -> ATGCCCGTCGG
GATGCGCTATG -> ATGCGCTATGC
GATGCGCTGTC -> ATGCGCTGTCG
GATGCTGAAAG -> ATGCTGAAAGA
GATGGAATGAT -> ATGGAATGATA
GATGGAGGACT -> ATGGAGGACTG
GATGGCGTAAA -> ATGGCGTAAAT
GATGTCTCATA -> ATGTCTCATAA
GATGTTTCTTA -> ATGTTTCTTAG
GATTAGATTGA -> ATTAGATTGAG
GATTCGCGCTG -> ATTCGCGCTGC
GATTGAGAGGG -> ATTGAGAGGGC
GATTGATACGT -> ATTGATACGTT
GATTGGCCGTC -> ATTGGCCGTCA
GATTGTCGTAC -> ATTGTCGTACG
GATTTATGGAA -> ATTTATGGAAC
GCAAATTAACT -> CAAATTAACTA
GCAACTTAACC -> CAACTTAACCA
GCAAGATAATA -> CAAGATAATAA
GCAAGTCTGTT -> CAAGTCTGTTG
GCAATGAGTGA -> CAATGAGTGAC
GCACAGAATAG -> CACAGAATAGA
GCACAGGCAGA -> CACAGGCAGAT
GCACAGGTCGA -> CACAGGTCGAG
GCACCAAGCTA -> CACCAAGCTAA
GCACGCGGTGA -> CACGCGGTGAT
GCACGCTGTAT -> CACGCTGTATG
GCACGTTTTCG -> CACGTTTTCGA
GCAGACAATTC -> CAGACAATTCC
GCAGATAAATG -> CAGATAAATGT
GCAGCCTCGGG -> CAGCCTCGGGT
GCAGCGCGGAG -> CAGCGCGGAGC
GCAGCGTAGAT -> CAGCGTAGATG
GCAGCGTTACC -> CAGCGTTACCG
GCAGGAAAATA -> CAGGAAAATAT
GCAGGAGTCCA -> CAGGAGTCCAG
GCAGGTATCCC -> CAGGTATCCCA
GCAGTGTTGAA -> CAGTGTTGAAA
GCAGTTTGTCC -> CAGTTTGTCCA
GCATAATCACC -> CATAATCACCG
GCATATGCCGC -> CATATGCCGCT
GCATCCAAATC -> CATCCAAATCC
GCATCCTCTCG -> CATCCTCTCGG
GCATGAAGACC -> CATGAAGACCA
GCCAACCGCCC -> CCAACCGCCCC
GCCAACGGACG -> CCAACGGACGT
GCCAAGTCCAC -> CCAAGTCCACG
GCCAGAGGCCC -> CCAGAGGCCCG
GCCAGATTGAT -> CCAGATTGATA
GCCAGCACGTT -> CCAGCACGTTT
GCCAGGCGTCA -> CCAGGCGTCAG
GCCAGTGGCGC -> CCAGTGGCGCC
GCCATAGCCGC -> CCATAGCCGCC
GCCATGGTGTT -> CCATGGTGTTG
GCCATGTGAAC -> CCATGTGAACT
GCCCAAAGCCT -> CCCAAAGCCTC
GCCCACCGAGC -> CCCACCGAGCC
GCCCATGACTG -> CCCATGACTGC
GCCCCCCCCAA -> CCCCCCCCAAG
GCCCCGTAAGC -> CCCCGTAAGCG
GCCCGAAAGTT -> CCCGAAAGTTC
GCCCGAGCTAG -> CCCGAGCTAGC
GCCCGGAGATC -> CCCGGAGATCT
GCCCGGGTACA -> CCCGGGTACAG
GCCCGTCGGAC -> CCCGTCGGACG
GCCCTAGGATG -> CCCTAGGATGT
GCCCTGTTAAC -> CCCTGTTAACG
GCCGATACAGC -> CCGATACAGCA
GCCGCCTGACC -> CCGCCTGACCT
GCCGCTAATGG -> CCGCTAATGGA
GCCGGGAACCA -> CCGGGAACCAT
GCCGGTTCTGA -> CCGGTTCTGAG
GCCGTCATAGA -> CCGTCATAGAT
GCCGTGGTCGA -> CCGTGGTCGAT
GCCTAATCGCA -> CCTAATCGCAG
GCCTCAACGTG -> CCTCAACGTGA
GCCTCAGACGG -> CCTCAGACGGG
GCCTCGGGTTC -> CCTCGGGTTCC
GCCTCTAAGCC -> CCTCTAAGCCA
GCCTGACCTCT -> CCTGACCTCTT
GCCTTATCATG -> CCTTATCATGG
GCCTTTTTTAC -> CCTTTTTTACT
GCGAACGGTTT -> CGAACGGTTTG
GCGACCGATAG -> CGACCGATAGC
GCGACGGCCGG -> CGACGGCCGGG
GCGAGGATGCT -> CGAGGATGCTG
GCGATACTTCA -> CGATACTTCAG
GCGCCTAATCG -> CGCCTAATCGC
GCGCGGAGCTG -> CGCGGAGCTGA
GCGCGTACTGA -> CGCGTACTGAA
GCGCTATGCAA -> CGCTATGCAAA
GCGCTGCGGTT -> CGCTGCGGTTC
GCGCTGTCGAA -> CGCTGTCGAAT
GCGCTTGAAAG -> CGCTTGAAAGA
GCGGAGCTGAA -> CGGAGCTGAAT
GCGGATGAAGA -> CGGATGAAGAA
GCGGGGCGGTT -> CGGGGCGGTTG
GCGGTACGGGA -> CGGTACGGGAA
GCGGTGATATG -> CGGTGATATGC
GCGGTGTAGTT -> CGGTGTAGTTC
GCGGTTCTTAT -> CGGTTCTTATG
GCGGTTGAGAC -> CGGTTGAGACA
GCGTAAATTGA -> CGTAAATTGAG
GCGTACTGAAT -> CGTACTGAATC
GCGTAGATGTT -> CGTAGATGTTT
GCGTAGTATAA -> CGTAGTATAAC
GCGTCAGGTAT -> CGTCAGGTATG
GCGTCCGCCAT -> CGTCCGCCATG
GCGTGAATAGG -> CGTGAATAGGA
GCGTGGGAGCC -> CGTGGGAGCCA
GCGTTACCGTG -> CGTTACCGTGG
GCTAAGTAGGT -> CTAAGTAGGTA
GCTAATGGATT -> CTAATGGATTG
GCTAATGTCGC -> CTAATGTCGCC
GCTAGCCTTTT -> CTAGCCTTTTT
GCTATGCAAAT -> CTATGCAAATT
GCTCATCGGGA -> CTCATCGGGAC
GCTCATTAGGT -> CTCATTAGGTA
GCTCGTCCTGC -> CTCGTCCTGCG
GCTCTCAATCT -> CTCTCAATCTT
GCTGAAAGATA -> CTGAAAGATAT
GCTGAACGCTC -> CTGAACGCTCA
GCTGAATACCC -> CTGAATACCCG
GCTGCGGTTCT -> CTGCGGTTCTT
GCTGGAACCCT -> CTGGAACCCTA
GCTGGGCCCAC -> CTGGGCCCACC
GCTGGTCGTGA -> CTGGTCGTGAG
GCTGGTTGCAC -> CTGGTTGCACA
GCTGTAGAGCC -> CTGTAGAGCCT
GCTGTATCTCT -> CTGTATCTCTC
GCTGTATGTCC -> CTGTATGTCCG
GCTGTCGAATG -> CTGTCGAATGA
GCTTCACCCGG -> CTTCACCCGGG
GCTTCCCCGGT -> CTTCCCCGGTA
GCTTCGTCATA -> CTTCGTCATAT
GCTTGAAAGAT -> CTTGAAAGATA
GGAAAATATGG -> GAAAATATGGG
GGAAATCTCTC -> GAAATCTCTCC
GGAAATTTCGT -> GAAATTTCGTC
GGAACCATGGA -> GAACCATGGAC
GGAACCCTAAC -> GAACCCTAACC
GGAACGCCAGA -> GAACGCCAGAT
GGAACTGCGAC -> GAACTGCGACG
GGAAGCTCGTC -> GAAGCTCGTCC
GGAATCTACAC -> GAATCTACACG
GGAATGATATC -> GAATGATATCA
GGACAATTGTG -> GACAATTGTGA
GGACATACCAT -> GACATACCATC
GGACGATGGCG -> GACGATGGCGT
GGACGTCCCAT -> GACGTCCCATG
GGACTAGCTGT -> GACTAGCTGTA
GGACTGGTGGT -> GACTGGTGGTA
GGACTTCAGTT -> GACTTCAGTTC
GGAGAACGTGT -> GAGAACGTGTT
GGAGATCTTAC -> GAGATCTTACC
GGAGCATAATC -> GAGCATAATCA
GGAGCCAGGCG -> GAGCCAGGCGT
GGAGCTCTCAA -> GAGCTCTCAAT
GGAGCTGAATA -> GAGCTGAATAC
GGAGGAATCTA -> GAGGAATCTAC
GGAGGACTGGT -> GAGGACTGGTG
GGAGGGGGGTT -> GAGGGGGGTTC
GGAGTCCAGTT -> GAGTCCAGTTT
GGATGAAGAAA -> GATGAAGAAAC
GGATGCTGAAA -> GATGCTGAAAG
GGATGTCTCAT -> GATGTCTCATA
GGATTAGATTG -> GATTAGATTGA
GGATTCGCGCT -> GATTCGCGCTG
GGATTGTCGTA -> GATTGTCGTAC
GGCAAGTCTGT -> GCAAGTCTGTT
GGCAATGAGTG -> GCAATGAGTGA
GGCACAGGCAG -> GCACAGGCAGA
GGCACCAAGCT -> GCACCAAGCTA
GGCACGCGGTG -> GCACGCGGTGA
GGCAGACAATT -> GCAGACAATTC
GGCAGATAAAT -> GCAGATAAATG
GGCAGCGTAGA -> GCAGCGTAGAT
GGCAGCGTTAC -> GCAGCGTTACC
GGCAGGAAAAT -> GCAGGAAAATA
GGCAGGTATCC -> GCAGGTATCCC
GGCAGTTTGTC -> GCAGTTTGTCC
GGCATATGCCG -> GCATATGCCGC
GGCCAGAGGCC -> GCCAGAGGCCC
GGCCCAAAGCC -> GCCCAAAGCCT
GGCCCACCGAG -> GCCCACCGAGC
GGCCCGAGCTA -> GCCCGAGCTAG
GGCCCGGGTAC -> GCCCGGGTACA
GGCCGATACAG -> GCCGATACAGC
GGCCGGGAACC -> GCCGGGAACCA
GGCCGTCATAG -> GCCGTCATAGA
GGCGAGGATGC -> GCGAGGATGCT
GGCGCCTAATC -> GCGCCTAATCG
GGCGGGGCGGT -> GCGGGGCGGTT
GGCGGTTGAGA -> GCGGTTGAGAC
GGCGTAAATTG -> GCGTAAATTGA
GGCGTAGTATA -> GCGTAGTATAA
GGCGTCAGGTA -> GCGTCAGGTAT
GGCGTCCGCCA -> GCGTCCGCCAT
GGCGTGAATAG -> GCGTGAATAGG
GGCTAAGTAGG -> GCTAAGTAGGT
GGCTGGTCGTG -> GCTGGTCGTGA
GGGAACCATGG -> GGAACCATGGA
GGGAACTGCGA -> GGAACTGCGAC
GGGACAATTGT -> GGACAATTGTG
GGGAGCCAGGC -> GGAGCCAGGCG
GGGAGGGGGGT -> GGAGGGGGGTT
GGGCAAGTCTG -> GGCAAGTCTGT
GGGCAGGAAAA -> GGCAGGAAAAT
GGGCATATGCC -> GGCATATGCCG
GGGCCAGAGGC -> GGCCAGAGGCC
GGGCCCACCGA -> GGCCCACCGAG
GGGCGAGGATG -> GGCGAGGATGC
GGGCGGTTGAG -> GGCGGTTGAGA
GGGCGTCCGCC -> GGCGTCCGCCA
GGGCTAAGTAG -> GGCTAAGTAGG
GGGGCAAGTCT -> GGGCAAGTCTG
GGGGCAGGAAA -> GGGCAGGAAAA
GGGGCATATGC -> GGGCATATGCC
GGGGCGGTTGA -> GGGCGGTTGAG
GGGGGCAGGAA -> GGGGCAGGAAA
GGGGGCATATG -> GGGGCATATGC
GGGGGGTTCTG -> GGGGGTTCTGG
GGGGGTTCTGG -> GGGGTTCTGGC
GGGGTTCTGGC -> GGGTTCTGGCT
GGGTACAGAGT -> GGTACAGAGTG
GGGTATTAAGT -> GGTATTAAGTC
GGGTTCCGAGG -> GGTTCCGAGGC
GGGTTCTGGCT -> GGTTCTGGCTG
GGTACACAAGC -> GTACACAAGCT
GGTACAGAGTG -> GTACAGAGTGA
GGTACAGTAGG -> GTACAGTAGGC
GGTACGGGAAC -> GTACGGGAACT
GGTACGTCTGA -> GTACGTCTGAT
GGTACTATTTA -> GTACTATTTAA
GGTAGCATACA -> GTAGCATACAG
GGTATCCCACG -> GTATCCCACGG
GGTATGGCGGG -> GTATGGCGGGG
GGTATGGTTGC -> GTATGGTTGCA
GGTATTAAGTC -> GTATTAAGTCC
GGTATTAGAGC -> GTATTAGAGCA
GGTCGAGTGCC -> GTCGAGTGCCT
GGTCGATCAGT -> GTCGATCAGTC
GGTCGTGAGAA -> GTCGTGAGAAG
GGTCTGAGTAG -> GTCTGAGTAGC
GGTCTTGCATC -> GTCTTGCATCC
GGTGACAAAGT -> GTGACAAAGTG
GGTGATATGCG -> GTGATATGCGC
GGTGCTTCGTC -> GTGCTTCGTCA
GGTGGTACAGT -> GTGGTACAGTA
GGTGTAGTTCA -> GTGTAGTTCAC
GGTGTTGATTG -> GTGTTGATTGG
GGTTCCGAGGC -> GTTCCGAGGCA
GGTTCTCACTG -> GTTCTCACTGC
GGTTCTGAGCC -> GTTCTGAGCCC
GGTTCTGGCTG -> GTTCTGGCTGG
GGTTCTTATGG -> GTTCTTATGGA
GGTTGAGACAA -> GTTGAGACAAT
GGTTGCACAGA -> GTTGCACAGAA
GGTTGCACGCT -> GTTGCACGCTG
GGTTTAATCGA -> GTTTAATCGAG
GGTTTCTGAGT -> GTTTCTGAGTC
GGTTTGAGTGC -> GTTTGAGTGCA
GTAAAGCCCTA -> TAAAGCCCTAG
GTAAATTGAGG -> TAAATTGAGGG
GTAAGCGTGGG -> TAAGCGTGGGA
GTACAAGAAGT -> TACAAGAAGTG
GTACAATTAAT -> TACAATTAATT
GTACACAAGCT -> TACACAAGCTG
GTACAGAGTGA -> TACAGAGTGAG
GTACAGGCACC -> TACAGGCACCA
GTACAGTAGGC -> TACAGTAGGCA
GTACGGCCCAA -> TACGGCCCAAA
GTACGGGAACT -> TACGGGAACTG
GTACGTATCGC -> TACGTATCGCT
GTACGTCGTAG -> TACGTCGTAGG
GTACGTCTGAT -> TACGTCTGATG
GTACTATTTAA -> TACTATTTAAG
GTACTGAATCA -> TACTGAATCAA
GTAGAGCCTCT -> TAGAGCCTCTA
GTAGATGTTTC -> TAGATGTTTCT
GTAGCAGGAGT -> TAGCAGGAGTC
GTAGGAAATTT -> TAGGAAATTTC
GTAGGCAGACA -> TAGGCAGACAA
GTAGGCAGGTA -> TAGGCAGGTAT
GTAGGCAGTTT -> TAGGCAGTTTG
GTAGGTATGGC -> TAGGTATGGCG
GTAGTAGTGCG -> TAGTAGTGCGA
GTAGTATAACG -> TAGTATAACGA
GTAGTGCGAAC -> TAGTGCGAACG
GTAGTTCACAG -> TAGTTCACAGA
GTATAACGATG -> TATAACGATGG
GTATCCCACGG -> TATCCCACGGA
GTATCGCTGGG -> TATCGCTGGGC
GTATCTCTCCT -> TATCTCTCCTA
GTATGGCGGGG -> TATGGCGGGGC
GTATGGTTGCA -> TATGGTTGCAC
GTATGTCCGAG -> TATGTCCGAGA
GTATGTCCTGA -> TATGTCCTGAT
GTATGTGACTC -> TATGTGACTCA
GTATTAAGTCC -> TATTAAGTCCA
GTATTAGAGCA -> TATTAGAGCAT
GTCAAAAATCG -> TCAAAAATCGG
GTCACGAACCT -> TCACGAACCTG
GTCACTGGGCT -> TCACTGGGCTA
GTCAGCTGTAT -> TCAGCTGTATC
GTCAGGTATGG -> TCAGGTATGGT
GTCATAGATCG -> TCATAGATCGT
GTCATATAGAT -> TCATATAGATA
GTCCACGAGCT -> TCCACGAGCTT
GTCCACTAGCG -> TCCACTAGCGA
GTCCACTGTCC -> TCCACTGTCCA
GTCCAGTTTAG -> TCCAGTTTAGA
GTCCATGCCAA -> TCCATGCCAAC
GTCCATGGTGA -> TCCATGGTGAC
GTCCCATGTAC -> TCCCATGTACA
GTCCCTGTGGG -> TCCCTGTGGGC
GTCCGAGATTT -> TCCGAGATTTA
GTCCGCCATGT -> TCCGCCATGTG
GTCCGCTTCCC -> TCCGCTTCCCC
GTCCTGATACG -> TCCTGATACGA
GTCCTGCGGAT -> TCCTGCGGATG
GTCGAATGAAC -> TCGAATGAACA
GTCGAGTGCCT -> TCGAGTGCCTC
GTCGATCAGTC -> TCGATCAGTCG
GTCGCCGGTTC -> TCGCCGGTTCT
GTCGGACGATG -> TCGGACGATGG
GTCGTACGGCC -> TCGTACGGCCC
GTCGTAGGCAG -> TCGTAGGCAGT
GTCGTGAGAAG -> TCGTGAGAAGT
GTCGTGTTTAG -> TCGTGTTTAGT
GTCGTTTATTG -> TCGTTTATTGG
GTCTCATAACC -> TCTCATAACCC
GTCTCTGACAA -> TCTCTGACAAT
GTCTCTTGATC -> TCTCTTGATCA
GTCTGAGTAGC -> TCTGAGTAGCA
GTCTGATGCGC -> TCTGATGCGCT,TCTGATGCGCT
GTCTGTTGAGC -> TCTGTTGAGCC
GTCTTGCATCC -> TCTTGCATCCA
GTGAACTCCTA -> TGAACTCCTAC
GTGAAGCGGTA -> TGAAGCGGTAC
GTGAATAGGAC -> TGAATAGGACT
GTGACAAAGTG -> TGACAAAGTGG
GTGACCAGCTC -> TGACCAGCTCA
GTGACGGAAAT -> TGACGGAAATC
GTGACTCAGGC -> TGACTCAGGCA
GTGAGAAGTCA -> TGAGAAGTCAA
GTGAGCCAACC -> TGAGCCAACCG
GTGAGCTGAAC -> TGAGCTGAACG
GTGAGGACTAG -> TGAGGACTAGC
GTGATATGCGC -> TGATATGCGCT
GTGCAGTGTTG -> TGCAGTGTTGA
GTGCCCGGAGA -> TGCCCGGAGAT
GTGCCTCAGAC -> TGCCTCAGACG
GTGCGAACGGT -> TGCGAACGGTT
GTGCTTCGTCA -> TGCTTCGTCAT
GTGGCACGCGG -> TGGCACGCGGT
GTGGCGCCTAA -> TGGCGCCTAAT
GTGGGAGCCAG -> TGGGAGCCAGG
GTGGGCGAGGA -> TGGGCGAGGAT
GTGGTACAGTA -> TGGTACAGTAG
GTGGTCGATCA -> TGGTCGATCAG
GTGGTCTGAGT -> TGGTCTGAGTA
GTGGTGCTTCG -> TGGTGCTTCGT
GTGTAGTTCAC -> TGTAGTTCACA
GTGTCTCTTGA -> TGTCTCTTGAT
GTGTTGAAAGA -> TGTTGAAAGAA
GTGTTGATGGA -> TGTTGATGGAA
GTGTTGATTGG -> TGTTGATTGGC
GTGTTTAGTTA -> TGTTTAGTTAT
GTTAAACGTTC -> TTAAACGTTCC
GTTAACCAGGT -> TTAACCAGGTT
GTTAACGGAGC -> TTAACGGAGCA
GTTACCGTGGT -> TTACCGTGGTG
GTTATTCTTAG -> TTATTCTTAGG
GTTCACAGAGC -> TTCACAGAGCC
GTTCAGTAGGA -> TTCAGTAGGAA
GTTCCAGGCGT -> TTCCAGGCGTA
GTTCCGAGGCA -> TTCCGAGGCAA
GTTCGCCCCGT -> TTCGCCCCGTA
GTTCGTCGTTT -> TTCGTCGTTTA
GTTCTCACTGC -> TTCTCACTGCG
GTTCTGAGCCC -> TTCTGAGCCCA
GTTCTGGCTGG -> TTCTGGCTGGT
GTTCTTATGGA -> TTCTTATGGAA
GTTGAAAGAAT -> TTGAAAGAATC
GTTGAGACAAT -> TTGAGACAATT
GTTGAGCCATG -> TTGAGCCATGG
GTTGATGGAAT -> TTGATGGAATG
GTTGATTGGCC -> TTGATTGGCCG
GTTGCACAGAA -> TTGCACAGAAT
GTTGCACGCTG -> TTGCACGCTGT
GTTGGTACTAT -> TTGGTACTATT
GTTTAATCGAG -> TTTAATCGAGT
GTTTAGAAATG -> TTTAGAAATGA
GTTTAGTTATT -> TTTAGTTATTC
GTTTATTGGAT -> TTTATTGGATT
GTTTCTGAGTC -> TTTCTGAGTCT
GTTTCTTAGCC -> TTTCTTAGCCA
GTTTGAGTGCA -> TTTGAGTGCAG
GTTTGTCCATG -> TTTGTCCATGG
GTTTTCGACTC -> TTTTCGACTCC
TAAAAGCAAGA -> AAAAGCAAGAT
TAAACGTTCCA -> AAACGTTCCAG
TAAAGCCCTAG -> AAAGCCCTAGG
TAAAGGATTAG -> AAAGGATTAGA
TAAATGTAAAG -> AAATGTAAAGC
TAAATTGAGGG -> AAATTGAGGGG
TAACATGACAA -> AACATGACAAC
TAACCAGAGAC -> AACCAGAGACG
TAACCAGGTTT -> AACCAGGTTTA
TAACCCCAATC -> AACCCCAATCG
TAACCTATCGC -> AACCTATCGCG
TAACGATGGAG -> AACGATGGAGG
TAACGGAGCAT -> AACGGAGCATA
TAACGTGCCCG -> AACGTGCCCGG
TAACTAGCTGG -> AACTAGCTGGT
TAACTATCATA -> AACTATCATAT
TAAGCCAAGTC -> AAGCCAAGTCC
TAAGCGTGGGA -> AAGCGTGGGAG
TAAGTAGGTAT -> AAGTAGGTATG
TAAGTAGTAGT -> AAGTAGTAGTG
TAAGTCCACTG -> AAGTCCACTGT
TAATAACGTGC -> AATAACGTGCC
TAATCACCGTT -> AATCACCGTTC
TAATCGAGTGG -> AATCGAGTGGC
TAATCGCAGCC -> AATCGCAGCCT
TAATGGATTGT -> AATGGATTGTC
TAATGTCGCCG -> AATGTCGCCGG
TAATTGCACAG -> AATTGCACAGG
TACAAGAAGTG -> ACAAGAAGTGA
TACAATGTACG -> ACAATGTACGT
TACAATTAATT -> ACAATTAATTG
TACACAAGCTG -> ACACAAGCTGG
TACACGAGTAT -> ACACGAGTATG
TACAGAGTGAG -> ACAGAGTGAGC
TACAGCATCCT -> ACAGCATCCTC
TACAGGCACCA -> ACAGGCACCAA
TACAGTACGTA -> ACAGTACGTAT
TACAGTAGGCA -> ACAGTAGGCAG
TACATTACAGT -> ACATTACAGTA
TACATTGCCTT -> ACATTGCCTTA
TACCAGGCCGA -> ACCAGGCCGAT
TACCATCTTTA -> ACCATCTTTAG
TACCCGTCCAT -> ACCCGTCCATG
TACCCTGACAC -> ACCCTGACACA
TACCGTGGTGC -> ACCGTGGTGCT
TACGAAGTACA -> ACGAAGTACAA
TACGGCCCAAA -> ACGGCCCAAAG
TACGGGAACTG -> ACGGGAACTGC
TACGTATCGCT -> ACGTATCGCTG
TACGTCAGCTG -> ACGTCAGCTGT
TACGTCGTAGG -> ACGTCGTAGGC
TACGTCTGATG -> ACGTCTGATGC
TACGTTGGTAC -> ACGTTGGTACT
TACTATTTAAG -> ACTATTTAAGT
TACTCTCGAGG -> ACTCTCGAGGA
TACTGAATCAA -> ACTGAATCAAG
TACTGTAGGCA -> ACTGTAGGCAG
TACTTCAGTCA -> ACTTCAGTCAC
TAGAAATGACC -> AGAAATGACCA
TAGACCGAAAC -> AGACCGAAACG
TAGAGCATGAA -> AGAGCATGAAG
TAGAGCCTCTA -> AGAGCCTCTAA
TAGAGGTTCTC -> AGAGGTTCTCA
TAGATATACAA -> AGATATACAAT
TAGATCGTTAA -> AGATCGTTAAA
TAGATGTTTCT -> AGATGTTTCTT
TAGATTGAGAG -> AGATTGAGAGG
TAGCAGGAGTC -> AGCAGGAGTCC
TAGCCAGCACG -> AGCCAGCACGT
TAGCCCGAAAG -> AGCCCGAAAGT
TAGCCGCCTGA -> AGCCGCCTGAC
TAGCCTTTTTT -> AGCCTTTTTTA
TAGCGACCGAT -> AGCGACCGATA
TAGCGATACTT -> AGCGATACTTC
TAGCTGGTTGC -> AGCTGGTTGCA
TAGCTGTAGAG -> AGCTGTAGAGC
TAGGAAATTTC -> AGGAAATTTCG
TAGGACTTCAG -> AGGACTTCAGT
TAGGAGCTCTC -> AGGAGCTCTCA
TAGGATGTCTC -> AGGATGTCTCA
TAGGCAGACAA -> AGGCAGACAAT
TAGGCAGGTAT -> AGGCAGGTATC
TAGGCAGTTTG -> AGGCAGTTTGT
TAGGGAGGGGG -> AGGGAGGGGGG
TAGGTATGGCG -> AGGTATGGCGG
TAGGTATTAGA -> AGGTATTAGAG
TAGTAGTGCGA -> AGTAGTGCGAA
TAGTATAACGA -> AGTATAACGAT
TAGTGCGAACG -> AGTGCGAACGG
TAGTTATTCTT -> AGTTATTCTTA
TAGTTCACAGA -> AGTTCACAGAG
TATAACGATGG -> ATAACGATGGA
TATACAATGTA -> ATACAATGTAC
TATAGATATAC -> ATAGATATACA
TATCATATTTC -> ATCATATTTCT
TATCATCGGTA -> ATCATCGGTAC
TATCATGGTTT -> ATCATGGTTTC
TATCCCACGGA -> ATCCCACGGAG
TATCGCGGTGT -> ATCGCGGTGTA
TATCGCTGGGC -> ATCGCTGGGCC
TATCTCTCCTA -> ATCTCTCCTAA
TATGCAAATTA -> ATGCAAATTAA
TATGCCGCTAA -> ATGCCGCTAAT
TATGCGCTTGA -> ATGCGCTTGAA
TATGGAACGCC -> ATGGAACGCCA
TATGGAAGCTC -> ATGGAAGCTCG
TATGGCGGGGC -> ATGGCGGGGCG
TATGGGGCAAG -> ATGGGGCAAGT
TATGGTTGCAC -> ATGGTTGCACG
TATGTCCGAGA -> ATGTCCGAGAT
TATGTCCTGAT -> ATGTCCTGATA
TATGTGACTCA -> ATGTGACTCAG
TATTAAGTCCA -> ATTAAGTCCAC
TATTAGAGCAT -> ATTAGAGCATG
TATTCTTAGGG -> ATTCTTAGGGA
TATTGGATTCG -> ATTGGATTCGC
TATTTAAGTAG -> ATTTAAGTAGT
TATTTACGTCA -> ATTTACGTCAG
TATTTCTTAGA -> ATTTCTTAGAG
TCAAAAATCGG -> CAAAAATCGGC
TCAACGTGAGC -> CAACGTGAGCC
TCAAGCCAGTG -> CAAGCCAGTGG
TCAATCTTCGA -> CAATCTTCGAT
TCACAGAGCCC -> CACAGAGCCCT
TCACCCGGGTA -> CACCCGGGTAT
TCACCGTTCGC -> CACCGTTCGCC
TCACGAACCTG -> CACGAACCTGG
TCACTGCGCGT -> CACTGCGCGTA
TCACTGGGCTA -> CACTGGGCTAA
TCAGACGGGCG -> CAGACGGGCGT
TCAGCAACTTA -> CAGCAACTTAA
TCAGCTGTATC -> CAGCTGTATCT
TCAGGCAGCGT -> CAGGCAGCGTT
TCAGGCGTGAA -> CAGGCGTGAAT
TCAGGTATGGT -> CAGGTATGGTT
TCAGTAGGAAA -> CAGTAGGAAAT
TCAGTCACGAA -> CAGTCACGAAC
TCAGTCGTGTT -> CAGTCGTGTTT
TCAGTTCAGTA -> CAGTTCAGTAG
TCATAACCCCA -> CATAACCCCAA
TCATAGATCGT -> CATAGATCGTT
TCATATAGATA -> CATATAGATAT
TCATATTTCTT -> CATATTTCTTA
TCATCGGGACA -> CATCGGGACAA
TCATCGGTACG -> CATCGGTACGT
TCATGGTTTCT -> CATGGTTTCTG
TCATTAGGTAT -> CATTAGGTATT
TCCAAATCCTT -> CCAAATCCTTG
TCCACGAGCTT -> CCACGAGCTTC
TCCACTAGCGA -> CCACTAGCGAC
TCCACTGTCCA -> CCACTGTCCAC
TCCAGGCGTAG -> CCAGGCGTAGT
TCCAGGGGGCA -> CCAGGGGGCAG
TCCAGTTTAGA -> CCAGTTTAGAA
TCCATACCCTG -> CCATACCCTGA
TCCATGCCAAC -> CCATGCCAACG
TCCATGGTGAC -> CCATGGTGACA
TCCCAAACAAC -> CCCAAACAACC
TCCCACGGAGG -> CCCACGGAGGA
TCCCATGTACA -> CCCATGTACAA
TCCCCGGTAGC -> CCCCGGTAGCA
TCCCTGTGGGC -> CCCTGTGGGCG
TCCGAACTCCC -> CCGAACTCCCA
TCCGAGATTTA -> CCGAGATTTAT
TCCGAGGCAAT -> CCGAGGCAATG
TCCGCCATGTG -> CCGCCATGTGA
TCCGCTTCCCC -> CCGCTTCCCCG
TCCTAAAAGCA -> CCTAAAAGCAA
TCCTAAAGGAT -> CCTAAAGGATT
TCCTACATTGC -> CCTACATTGCC
TCCTCTCGGCC -> CCTCTCGGCCC
TCCTGATACGA -> CCTGATACGAA
TCCTGCGGATG -> CCTGCGGATGA
TCCTGTCTGAT -> CCTGTCTGATG
TCCTTGATACT -> CCTTGATACTG
TCGAATGAACA -> CGAATGAACAG
TCGACTCCTGT -> CGACTCCTGTC
TCGAGACGTTA -> CGAGACGTTAA
TCGAGGAGAAC -> CGAGGAGAACG
TCGAGTGCCTC -> CGAGTGCCTCA
TCGAGTGGCAC -> CGAGTGGCACG
TCGATCAGTCG -> CGATCAGTCGT
TCGATGCCCGT -> CGATGCCCGTC
TCGCAGCCTCG -> CGCAGCCTCGG
TCGCCCCGTAA -> CGCCCCGTAAG
TCGCCGGTTCT -> CGCCGGTTCTG
TCGCGCTGCGG -> CGCGCTGCGGT
TCGCGGTGTAG -> CGCGGTGTAGT
TCGCTGGGCCC -> CGCTGGGCCCA
TCGGACGATGG -> CGGACGATGGC
TCGGCACAGGC -> CGGCACAGGCA
TCGGCCCGGGT -> CGGCCCGGGTA
TCGGGACAATT -> CGGGACAATTG
TCGGGTTCCGA -> CGGGTTCCGAG
TCGGTACGTCT -> CGGTACGTCTG
TCGTACAGGCA -> CGTACAGGCAC
TCGTACGGCCC -> CGTACGGCCCA
TCGTAGGCAGT -> CGTAGGCAGTT
TCGTCACTGGG -> CGTCACTGGGC
TCGTCATATAG -> CGTCATATAGA
TCGTCCCTGTG -> CGTCCCTGTGG
TCGTCCTGCGG -> CGTCCTGCGGA
TCGTCGTTTAT -> CGTCGTTTATT
TCGTGAGAAGT -> CGTGAGAAGTC
TCGTGTTTAGT -> CGTGTTTAGTT
TCGTTAAACGT -> CGTTAAACGTT
TCGTTTATTGG -> CGTTTATTGGA
TCTAAGCCAAG -> CTAAGCCAAGT
TCTACACGAGT -> CTACACGAGTA
TCTAGGAGCTC -> CTAGGAGCTCT
TCTCAATCTTC -> CTCAATCTTCG
TCTCACTGCGC -> CTCACTGCGCG
TCTCATAACCC -> CTCATAACCCC
TCTCCATACCC -> CTCCATACCCT
TCTCCTAAAGG -> CTCCTAAAGGA
TCTCGAGGAGA -> CTCGAGGAGAA
TCTCGGCCCGG -> CTCGGCCCGGG
TCTCTCCATAC -> CTCTCCATACC
TCTCTCCTAAA -> CTCTCCTAAAG
TCTCTGACAAT -> CTCTGACAATC
TCTCTTGATCA -> CTCTTGATCAG
TCTGACAATCG -> CTGACAATCGT
TCTGAGCCCAT -> CTGAGCCCATG
TCTGAGTAGCA -> CTGAGTAGCAG
TCTGAGTCTCT -> CTGAGTCTCTG
TCTGATAACTA -> CTGATAACTAT
TCTGATGCGCT -> CTGATGCGCTA,CTGATGCGCTG
TCTGGCTGGTC -> CTGGCTGGTCG
TCTGTTGAGCC -> CTGTTGAGCCA
TCTTACCAGGC -> CTTACCAGGCC
TCTTAGAGGTT -> CTTAGAGGTTC
TCTTAGCCAGC -> CTTAGCCAGCA
TCTTAGGGAGG -> CTTAGGGAGGG
TCTTATGGAAG -> CTTATGGAAGC
TCTTCCTAAAA -> CTTCCTAAAAG
TCTTCGATGCC -> CTTCGATGCCC
TCTTGATCAGG -> CTTGATCAGGC
TCTTGCATCCA -> CTTGCATCCAA
TCTTTAGCCCG -> CTTTAGCCCGA
TGAAAGAATCT -> GAAAGAATCTG
TGAAAGATAAC -> GAAAGATAACA
TGAAAGATATT -> GAAAGATATTT
TGAACAGAAAG -> GAACAGAAAGC
TGAACGCTCAT -> GAACGCTCATT
TGAACTCCTAC -> GAACTCCTACA
TGAAGAAACGT -> GAAGAAACGTG
TGAAGACCAGT -> GAAGACCAGTA
TGAAGCGGTAC -> GAAGCGGTACG
TGAATACCCGT -> GAATACCCGTC
TGAATAGGACT -> GAATAGGACTT
TGAATCAAGCC -> GAATCAAGCCA
TGACAAAGTGG -> GACAAAGTGGT
TGACAACGACT -> GACAACGACTA
TGACAATCGTC -> GACAATCGTCA
TGACACAAAAG -> GACACAAAAGT
TGACCAACCAT -> GACCAACCATT
TGACCAGCTCA -> GACCAGCTCAT
TGACCTCTTCC -> GACCTCTTCCT
TGACGGAAATC -> GACGGAAATCT
TGACTCAGGCA -> GACTCAGGCAG
TGACTGCAGCG -> GACTGCAGCGC
TGAGAAGTCAA -> GAGAAGTCAAA
TGAGACAATTC -> GAGACAATTCA
TGAGAGGGCCA -> GAGAGGGCCAG
TGAGCCAACCG -> GAGCCAACCGC
TGAGCCATGGT -> GAGCCATGGTG
TGAGCCCATGA -> GAGCCCATGAC
TGAGCTGAACG -> GAGCTGAACGC
TGAGGACTAGC -> GAGGACTAGCT
TGAGGGGGCAT -> GAGGGGGCATA
TGAGTAGCAGG -> GAGTAGCAGGA
TGAGTCTCTGA -> GAGTCTCTGAC
TGAGTGACGGA -> GAGTGACGGAA
TGAGTGCAGTG -> GAGTGCAGTGT
TGATAACTATC -> GATAACTATCA
TGATACGAAGT -> GATACGAAGTA
TGATACGTTGG -> GATACGTTGGT
TGATACTGTAG -> GATACTGTAGG
TGATATCATCG -> GATATCATCGG
TGATATGCGCT -> GATATGCGCTT
TGATCAGGCGT -> GATCAGGCGTG
TGATGCGCTAT -> GATGCGCTATG
TGATGCGCTGT -> GATGCGCTGTC
TGATGGAATGA -> GATGGAATGAT
TGATTGGCCGT -> GATTGGCCGTC
TGCAAATTAAC -> GCAAATTAACT
TGCACAGAATA -> GCACAGAATAG
TGCACAGGTCG -> GCACAGGTCGA
TGCACGCTGTA -> GCACGCTGTAT
TGCAGCGCGGA -> GCAGCGCGGAG
TGCAGTGTTGA -> GCAGTGTTGAA
TGCATCCAAAT -> GCATCCAAATC
TGCCAACGGAC -> GCCAACGGACG
TGCCCGGAGAT -> GCCCGGAGATC
TGCCCGTCGGA -> GCCCGTCGGAC
TGCCGCTAATG -> GCCGCTAATGG
TGCCTCAGACG -> GCCTCAGACGG
TGCCTTATCAT -> GCCTTATCATG
TGCGAACGGTT -> GCGAACGGTTT
TGCGACGGCCG -> GCGACGGCCGG
TGCGCGTACTG -> GCGCGTACTGA
TGCGCTATGCA -> GCGCTATGCAA
TGCGCTGTCGA -> GCGCTGTCGAA
TGCGCTTGAAA -> GCGCTTGAAAG
TGCGGATGAAG -> GCGGATGAAGA
TGCGGTTCTTA -> GCGGTTCTTAT
TGCTGAAAGAT -> GCTGAAAGATA
TGCTTCGTCAT -> GCTTCGTCATA
TGGAACCCTAA -> GGAACCCTAAC
TGGAACGCCAG -> GGAACGCCAGA
TGGAAGCTCGT -> GGAAGCTCGTC
TGGAATGATAT -> GGAATGATATC
TGGACATACCA -> GGACATACCAT
TGGAGGACTGG -> GGAGGACTGGT
TGGATTCGCGC -> GGATTCGCGCT
TGGATTGTCGT -> GGATTGTCGTA
TGGCACGCGGT -> GGCACGCGGTG
TGGCAGCGTAG -> GGCAGCGTAGA
TGGCCGTCATA -> GGCCGTCATAG
TGGCGCCTAAT -> GGCGCCTAATC
TGGCGGGGCGG -> GGCGGGGCGGT
TGGCGTAAATT -> GGCGTAAATTG
TGGCTGGTCGT -> GGCTGGTCGTG
TGGGAGCCAGG -> GGGAGCCAGGC
TGGGCCCACCG -> GGGCCCACCGA
TGGGCGAGGAT -> GGGCGAGGATG
TGGGCTAAGTA -> GGGCTAAGTAG
TGGGGCAAGTC -> GGGGCAAGTCT
TGGTACAGTAG -> GGTACAGTAGG
TGGTACTATTT -> GGTACTATTTA
TGGTCGATCAG -> GGTCGATCAGT
TGGTCGTGAGA -> GGTCGTGAGAA
TGGTCTGAGTA -> GGTCTGAGTAG
TGGTGACAAAG -> GGTGACAAAGT
TGGTGCTTCGT -> GGTGCTTCGTC
TGGTGGTACAG -> GGTGGTACAGT
TGGTGTTGATT -> GGTGTTGATTG
TGGTTGCACAG -> GGTTGCACAGA
TGGTTGCACGC -> GGTTGCACGCT
TGGTTTCTGAG -> GGTTTCTGAGT
TGTAAAGCCCT -> GTAAAGCCCTA
TGTACAAGAAG -> GTACAAGAAGT
TGTACGTCGTA -> GTACGTCGTAG
TGTAGAGCCTC -> GTAGAGCCTCT
TGTAGGCAGGT -> GTAGGCAGGTA
TGTAGTTCACA -> GTAGTTCACAG
TGTATCTCTCC -> GTATCTCTCCT
TGTATGTCCGA -> GTATGTCCGAG
TGTCCACTAGC -> GTCCACTAGCG
TGTCCATGGTG -> GTCCATGGTGA
TGTCCGAGATT -> GTCCGAGATTT
TGTCCTGATAC -> GTCCTGATACG
TGTCGAATGAA -> GTCGAATGAAC
TGTCGCCGGTT -> GTCGCCGGTTC
TGTCGTACGGC -> GTCGTACGGCC
TGTCTCATAAC -> GTCTCATAACC
TGTCTCTTGAT -> GTCTCTTGATC
TGTCTGATGCG -> GTCTGATGCGC
TGTGAACTCCT -> GTGAACTCCTA
TGTGACTCAGG -> GTGACTCAGGC
TGTGAGGACTA -> GTGAGGACTAG
TGTGGGCGAGG -> GTGGGCGAGGA
TGTTAACGGAG -> GTTAACGGAGC
TGTTGAAAGAA -> GTTGAAAGAAT
TGTTGAGCCAT -> GTTGAGCCATG
TGTTGATGGAA -> GTTGATGGAAT
TGTTGATTGGC -> GTTGATTGGCC
TGTTTAGTTAT -> GTTTAGTTATT
TGTTTCTTAGC -> GTTTCTTAGCC
TTAAACGTTCC -> TAAACGTTCCA
TTAACCAGAGA -> TAACCAGAGAC
TTAACCAGGTT -> TAACCAGGTTT
TTAACGGAGCA -> TAACGGAGCAT
TTAACTAGCTG -> TAACTAGCTGG
TTAAGTAGTAG -> TAAGTAGTAGT
TTAAGTCCACT -> TAAGTCCACTG
TTAATCGAGTG -> TAATCGAGTGG
TTAATTGCACA -> TAATTGCACAG
TTACAGTACGT -> TACAGTACGTA
TTACCAGGCCG -> TACCAGGCCGA
TTACCGTGGTG -> TACCGTGGTGC
TTACGTCAGCT -> TACGTCAGCTG
TTACTCTCGAG -> TACTCTCGAGG
TTAGAAATGAC -> TAGAAATGACC
TTAGAGCATGA -> TAGAGCATGAA
TTAGAGGTTCT -> TAGAGGTTCTC
TTAGATTGAGA -> TAGATTGAGAG
TTAGCCAGCAC -> TAGCCAGCACG
TTAGCCCGAAA -> TAGCCCGAAAG
TTAGGGAGGGG -> TAGGGAGGGGG
TTAGGTATTAG -> TAGGTATTAGA
TTAGTTATTCT -> TAGTTATTCTT
TTATCATGGTT -> TATCATGGTTT
TTATGGAACGC -> TATGGAACGCC
TTATGGAAGCT -> TATGGAAGCTC
TTATTCTTAGG -> TATTCTTAGGG
TTATTGGATTC -> TATTGGATTCG
TTCACAGAGCC -> TCACAGAGCCC
TTCACCCGGGT -> TCACCCGGGTA
TTCAGCAACTT -> TCAGCAACTTA
TTCAGTAGGAA -> TCAGTAGGAAA
TTCAGTCACGA -> TCAGTCACGAA
TTCAGTTCAGT -> TCAGTTCAGTA
TTCCAGGCGTA -> TCCAGGCGTAG
TTCCAGGGGGC -> TCCAGGGGGCA
TTCCCCGGTAG -> TCCCCGGTAGC
TTCCGAACTCC -> TCCGAACTCCC
TTCCGAGGCAA -> TCCGAGGCAAT
TTCCTAAAAGC -> TCCTAAAAGCA
TTCGACTCCTG -> TCGACTCCTGT
TTCGATGCCCG -> TCGATGCCCGT
TTCGCCCCGTA -> TCGCCCCGTAA
TTCGCGCTGCG -> TCGCGCTGCGG
TTCGTCATATA -> TCGTCATATAG
TTCGTCCCTGT -> TCGTCCCTGTG
TTCGTCGTTTA -> TCGTCGTTTAT
TTCTCACTGCG -> TCTCACTGCGC
TTCTGAGCCCA -> TCTGAGCCCAT
TTCTGAGTCTC -> TCTGAGTCTCT
TTCTGGCTGGT -> TCTGGCTGGTC
TTCTTAGAGGT -> TCTTAGAGGTT
TTCTTAGCCAG -> TCTTAGCCAGC
TTCTTAGGGAG -> TCTTAGGGAGG
TTCTTATGGAA -> TCTTATGGAAG
TTGAAAGAATC -> TGAAAGAATCT
TTGAAAGATAA -> TGAAAGATAAC
TTGAGACAATT -> TGAGACAATTC
TTGAGAGGGCC -> TGAGAGGGCCA
TTGAGCCATGG -> TGAGCCATGGT
TTGAGGGGGCA -> TGAGGGGGCAT
TTGAGTGCAGT -> TGAGTGCAGTG
TTGATACGTTG -> TGATACGTTGG
TTGATACTGTA -> TGATACTGTAG
TTGATCAGGCG -> TGATCAGGCGT
TTGATGGAATG -> TGATGGAATGA
TTGATTGGCCG -> TGATTGGCCGT
TTGCACAGAAT -> TGCACAGAATA
TTGCACAGGTC -> TGCACAGGTCG
TTGCACGCTGT -> TGCACGCTGTA
TTGCATCCAAA -> TGCATCCAAAT
TTGCCTTATCA -> TGCCTTATCAT
TTGGATTCGCG -> TGGATTCGCGC
TTGGCCGTCAT -> TGGCCGTCATA
TTGGTACTATT -> TGGTACTATTT
TTGTCCATGGT -> TGTCCATGGTG
TTGTCGTACGG -> TGTCGTACGGC
TTGTGAGGACT -> TGTGAGGACTA
TTTAAGTAGTA -> TTAAGTAGTAG
TTTAATCGAGT -> TTAATCGAGTG
TTTACGTCAGC -> TTACGTCAGCT
TTTACTCTCGA -> TTACTCTCGAG
TTTAGAAATGA -> TTAGAAATGAC
TTTAGCCCGAA -> TTAGCCCGAAA
TTTAGTTATTC -> TTAGTTATTCT
TTTATGGAACG -> TTATGGAACGC
TTTATTGGATT -> TTATTGGATTC
TTTCGACTCCT -> TTCGACTCCTG
TTTCGTCCCTG -> TTCGTCCCTGT
TTTCTGAGTCT -> TTCTGAGTCTC
TTTCTTAGAGG -> TTCTTAGAGGT
TTTCTTAGCCA -> TTCTTAGCCAG
TTTGAGTGCAG -> TTGAGTGCAGT
TTTGTCCATGG -> TTGTCCATGGT
TTTTACTCTCG -> TTTACTCTCGA
TTTTCGACTCC -> TTTCGACTCCT
TTTTTACTCTC -> TTTTACTCTCG
TTTTTTACTCT -> TTTTTACTCTC
